შარაბ-ი	[Bedeutung unklar]
თანამგებ-ი	antwortend
ნაანგაჰრებ-ი	an sich gerissen, erworben
მჭეშმარიტებ-ი	wahrheitssagend, wahrhaftig
შემტყუებ-ი	begreifend, verstehend, erkennend
ესეკალიბ-ი	so ein, solch
ნაწდობ-ი	gestählt, gehärtet
აღმსთობ-ი	früh aufgestanden, früh aufstehend
მგლახაკობ-ი	arm
თანამჴმობ-ი	einverstanden
მედნობ-ი	schmelzend, vergehend
მსაქმიერობ-ი	arbeitend
მძჳრობ-ი	Verbrecher, übeltäter
მჭჳრობ-ი	sehend
თანანაშობ-ი	ähnlich geboren
ქარდაგ-ი	[Bedeutung unklar]
თანანერგ-ი	verwandt
ჴშირადნერგ-ი	dicht gepflanzt, dicht gewachsen
განმზადებად-ი	vorzubereitend
გამოცხადებად-ი	zu erscheinend
მოლოდებად-ი	zu erwartend
დაძუელებად-ი	alt zu werdend
დაბრკოლებად-ი	zu irrend, zu verführend
განშიშულებად-ი	entblößbar
წამებად-ი	zu folternd, zu marternd
დაყენებად-ი	zu ernennend, zu berufend
ვნებად-ი	zu schädigend
ცხოვნებად-ი	zu erlösend, zu rettend
დაცჳვნებად-ი	zu fallend
დაბერებად-ი	zu alternd
ცხოვრებად-ი	zu erlösend, zu rettend
განშორებად-ი	entfernbar
წარმატებად-ი	erfolgsträchtig
დადნობად-ი	zu schmelzend
დაჭნობად-ი	zu verwelkend
დალპობად-ი	zu faulend
თავად-თავად-ი	jeder einzelne
დარღუევად-ი	zu zerstörend, zu zerrüttend
შემთხუევად-ი	zu begegnend, zu erleidend
მიმოდაქცევად-ი	umgebogen, hin- und hergebogen
მიმოდქცევად-ი	hin- und hergebogen, krumm
მოკლვად-ი	zu tötend
ვლტოლვად-ი	wovor man flüchten muß
თჳთძრვად-ი	selbstlaufend, selbstfahrend
განკუეთად-ი	abzuschneidend, abzutrennend
წუთად-ი	kurzzeitig
ნელიად-ი	langsam, ruhig
სრულიად-ი	ganz, vollständig
ღრმიად-ი	tief, schwer verständlich
მძაფრიად-ი	stark
გრძიად-ი	lang
საკჳრველად-ი	erstaunlich, wunderbar
ჴორციელად-ი	fleischlich, körperlich
განსწავლად-ი	zu erlernend
ადგილად-ადგილად-ი	örtlich
თესლად-ი	zu säend
თესლად-თესლად-ი	verschieden, unterschiedlich
წლითიწლად-ი	alljährlich
დაცემად-ი	zu stürzend, zu zerstörend
მიცემად-ი	hinzugebend
მოცემად-ი	zu gebend
წინააღდგომად-ი	Gegen-, gegenteilig
დაშდომად-ი	zu bleibend
ტომად-ტომად-ი	stammesweise, volksweise
განძღომად-ი	sattmachend
თქუმად-ი	zu sagend
ჴელთდასხმად-ი	einzusetzend, festzulegend
ზრზენად-ი	aufhetzend, aufstachelnd
გამოჴსნად-ი	zu erlösend, zu befreiend, zu helfend
ფსალმუნ-ფსალმუნად-ი	Psalm für Psalm (gesungen)
განრყუნად-ი	zu verderbend
ძჳრ-ძჳრად-ი	überaus grausam
სათნოყოფად-ი	gefällig
კაცად-ი	ein jeder
მოწად-ი	wünschend
ძნელბედ-ი	armselig, notleidend
წაღმართმორბედ-ი	geradeausgehend, auf dem richtigen Weg wandelnd
მიმორბედ-ი	hin- und herrennend
მკჳრცხლმორბედ-ი	zu Fuß laufend / rennend
გძიდედ-ი	verlängert
ჭალედ-ი	mit Gerüststäben (für eine Dachplane) versehen
მრავალმუჴლედ-ი	ausführlich, vielteilig
ქველისმოქმედ-ი	Barmherzigkeit übend
კეთილისმოქმედ-ი	wohltätig, Gutes tuend
საქმისმოქმედ-ი	arbeitend, tätig
სახისმოქმედ-ი	herausarbeitend, herausmeißelnd, machend
ამაოჲსმოქმედ-ი	vergebens tätig
ხაოედ-ი	flauschig, zottig
მუსმარედ-ი	mit Nägeln versehen
მცენარედ-ი	zum Aufwachsen bestimmt
ოთხოთხპირედ-ი	je viergestaltig
მცირედ-მცირედ-ი	wenig, ganz wenig, leicht
ოთხხატედ-ი	viergestaltig
სწორრიცხუედ-ი	gleichmäßig
დღითიდღედ-ი	täglich
ოქრონაჭედ-ი	vergoldet, goldbeschlagen
სახედ-სახედ-ი	unterschiedlich, verschieden
ფრთადიდ-ი	großflügelig
ძალდიდ-ი	stark
ჴორცდიდ-ი	groß, hochgewachsen, breitschultrig
ფერჴდიდ-ი	großfüßig
მორიდ-ი	zurückhaltend, schüchtern, ausweichend
მოკლეკუდ-ი	kurzschwänzig
ცხჳრმრუდ-ი	krummnasig
მნებავ-ი	wünschend
უღობავ-ი	ungezügelt, nicht aufzuhalten
გარემოჲსშესახედავ-ი	ringsum zu sehend
მოქირდავ-ი	verspottend, auslachend
ზედადასართავ-ი	hinzufügend, überflüssig
მისართავ-ი	hinzuzufügend
მისათუალავ-ი	dafürzuhaltend, zu geltend
შეუმშჭუალავ-ი	unbefestigt
განსახილავ-ი	zu sehend, zu erblickend
გემოჲსუხილავ-ი	hungrig
ნაოფლავ-ი	in Schweiß erarbeitet
საშუღლავ-ი	strittig, umstritten
მრავალსაზრუნავ-ი	sehr zu betreuend, sehr zu umsorgend
მოზრუნავ-ი	betreuend, fürsorgend
უნიშნავ-ი	merkmallos
სადრტჳნავ-ი	Klage, zerstörend, behindernd
განსაპარავ-ი	zu stehlend
ნაკერავ-ი	genäht
სიტყჳსმკერავ-ი	mit Worten heilend, kundig
შენაწირავ-ი	geopfert
აღუჰამრავ-ი	zahllos, ungezählt
შესამურავ-ი	mit Myrrhe zu salbend
თანნათესავ-ი	verwandt
უთესავ-ი	ungesät
ფასისმოსავ-ი	reichtumliebend, besitzliebend
მზუავ-ი	stolz, hochmütig
მზაკუავ-ი	hinterlistig
თუალთმოხუავ-ი	voreingenommen
აღსარაცხუავ-ი	zu zählend
საფქავ-ი	zu mahlend
მოფქავ-ი	mahlend
მრავალსალოცავ-ი	sehr zu erflehend
უცავ-ი	ungeschützt
გარეშეუცავ-ი	grenzenlos
მფუცავ-ი	schwörend
მრავალმფუცავ-ი	oft schwörend
კეთილისმობაძავ-ი	Gutes nachahmend
მოსარეწავ-ი	zu erwerbend, zu besorgend
მკრეხავ-ი	raubend, plündernd
წარსაკითხავ-ი	zu lesend
პირჰავ-ი	übelredend
ნასყიდევ-ი	gekauft
რვალნაწლევ-ი	grausam
ნამწუარევ-ი	verbrannt; verbrannt
მართლუკუნმქცევ-ი	zurückschickend, umkehren lassend, zurückgekehrt
მიმომქცევ-ი	schwankend, wankend
ძლივ-ი	stark, mächtig, fest
ჰურიებრივ-ი	jüdisch
გლახაკებრივ-ი	arm, bettelarm
მუსიკებრივ-ი	musikalisch
ჭაბუკებრივ-ი	jugendlich
მჴევლებრივ-ი	sklavisch
მამებრივ-ი	väterlich
ყრმებრივ-ი	kindlich; kindlich
ძმებრივ-ი	brüderlich
მდედრებრივ-ი	weiblich
სულიერებრივ-ი	seelisch
მთავრებრივ-ი	fürstlich
ვირებრივ-ი	eselhaft
მჴეცებრივ-ი	wild; wild
ძმობრივ-ი	brüderlich; brüderlich
მეფობრივ-ი	königlich
მამაკაცობრივ-ი	männlich
პურადუხვ-ი	reich bewirtend
მანქლიოზ-ი	[Bedeutung unklar]
სამეოცდაათ-ი	siebzig
ორმეოცდაათ-ი	fünfzig
ოთხმეოცდაათ-ი	neunzig
მაგათ-ი	ihr, deren
ვიეთ-ი	manches, von manchem
ჰინდოეთ-ი	Indien, äthiopien
ჰასეთ-ი	so ein, solch
წილგდებით-ი	durch Los entschieden
განტევებით-ი	freigelassen, frei, einzeln
მართებით-ი	wahrhaftig, wirklich
მიმოცვალებით-ი	veränderlich
წინაწარმეტყუელებით-ი	prophetisch
შემკობილებით-ი	schön
განგებულებით-ი	beabsichtigt
ერთგულებით-ი	treu, vertrauenswürdig
მომრგულებით-ი	rund, kreisförmig
კრძალულებით-ი	vorsichtig
განკრძალულებით-ი	vorsichtig, zurückhaltend
ქმნულებით-ი	gemacht, schön
სრულებით-ი	ganz, vollständig
განშუენებით-ი	geschmückt, verschönt, gut
გამოჩინებით-ი	klar, deutlich
წარმოჩინებით-ი	zu zeigend, beispielhaft
ქორწინებით-ი	ehelich
მოგონებით-ი	überlegt, beabsichtigt
რწმუნებით-ი	überzeugend
უსამართლოებით-ი	ungerecht
უსჯულოებით-ი	unanständig, gesetzeswidrig
სათნოებით-ი	gefällig
მყუდროებით-ი	still, ruhig
მარტოებით-ი	einzeln
სიბრძნისმოყუარებით-ი	philosophisch, weise
მშჳნვიერებით-ი	seelisch
კადნიერებით-ი	dreist
მეცნიერებით-ი	verstanden, bewußt
მძლავრებით-ი	gewaltsam, gezwungen
მოძღურებით-ი	unterweisend
კეთილადმსახურებით-ი	gerecht
ღირსებით-ი	würdig
ჭეშმარიტებით-ი	wirklich, wahrhaftig
გარეთშემოღებით-ი	unnatürlich
ზუაობით-ი	stolz, überheblich
მოვალეობით-ი	notwendig
მეშუღლეობით-ი	feindlich
მეჰაზრეობით-ი	vernünftig, verständig
მესიზმრეობით-ი	Traum-, unklar
მესტეჭეობით-ი	ungläubig
მართლმადიდებლობით-ი	orthodox
მჩუენებლობით-ი	pharisäerhaft
შემომკრებელობით-ი	versammelnd, sammelnd, vereinigend
თჳთმფლობელობით-ი	frei, unabhängig
მიმოდაუბნეველობით-ი	unteilbar, unverstreut
თანაგანმხილველობით-ი	gesetzlich, ordentlich
განუნახველობით-ი	willkürlich
დამსახველობით-ი	scheinbar
მომმუხველობით-ი	verbrennend, reißen / platzen lassend
სახისმჩემელობით-ი	heuchlerisch, betrügerisch
უშრომელობით-ი	ohne zu arbeiten, mühelos
ცხოვლობით-ი	belebend
ცილობით-ი	strittig
იჭუნეულობით-ი	mißtrauisch
მოპარულობით-ი	Diebes-, diebisch
მიმდემობით-ი	ununterbrochen
თანალმობით-ი	mitfühlend
შემდგომობით-ი	folgender
მოწმობით-ი	bezeugend, bestätigend
ერთჴმობით-ი	einmütig
ქრისტეანობით-ი	christlich
მგოსნობით-ი	bardisch, musikalisch
უსამართლოობით-ი	ungerecht
მეგობრობით-ი	freundschaftlich
ღმერთმთავრობით-ი	göttlich
პაექრობით-ი	strittig
სიწმიდით-ი	rein, makellos
იგავით-ი	ähnlich, angeglichen
ზითევით-ი	Mitgift habend
მრავალშემთხუევით-ი	vielfältig
გამობერვით-ი	durch Blasen hergestellt (Glas)
ზაკუვით-ი	heimtückisch
თანაზრახვით-ი	glaubhaft
სიგლახაკით-ი	bedürftig
ტყუილით-ი	lügnerisch, verlogen
წილით-ი	durch Los entschieden
სიხარულით-ი	freudig, froh
ძლით-ი	wegen; der Kraft / dem Können entsprechend
მამით-ი	väterlicherseits
თანამამით-ი	von einem Vater stammend
წინააღდგომით-ი	gegenteilig, gegensätzlich
ზომით-ი	maßvoll
დაშრომით-ი	erschöpft, abgearbeitet, belästigend
საქმით-ი	vollendet, erledigt
მარცხენით-ი	links befindlich; heimtückisch
ზედამიწევნით-ი	wahrhaftig, genau
საჴმრით-ი	notwendig
ნეფსით-ი	freiwillig geschehen; freiwillig geschehen
სწრაფით-ი	schnell, rasch
განყოფით-ი	einzeln, getrennt
წინადღით-ი	gestrig
სახით-ი	ähnlich, bildhaft, übertragen, metaphorisch
სადეროთ-ი	(Schlacht)reihe; (Schlacht)reihe
მათდამიმართ-ი	für sie bestimmt
წინაგანმწყობისამიმართ-ი	gegenteilig, gegnerisch
მისამიმართ-ი	zu ihm gewandt / gerichtet, ihm zustehend
სიმდაბლისმიმართ-ი	bescheiden
ერთმანერთ-ი	einander
სატჳრთ-ი	Last, Bürde, aufzuladend
მარცხენჱთ-ი	links befindlich; heimtückisch
ეგრჱთ-ი	solch
ესრჱთ-ი	so ein, solch
ანაზდაჲთ-ი	unverhofft, unerwartet
წინაჲთ-ი	früherer
იშჳთ-ი	selten
ნაბაკ-ი	gelagert
ნაჩხრეკ-ი	geschrieben
ძჳრისმკრებალ-ი	böse, Böses sammelnd
გარემავალ-ი	herumstreunend
წინაგამომავალ-ი	allererster
ზენადამომავალ-ი	herabkommend
თანაშთამომავალ-ი	fürsorgend
მყისწარმავალ-ი	rasch entschwindend
ქმრისცოლისმავალ-ი	frauenähnlich
წიაღმავალ-ი	überquerend, hinübergehend
თმამრავალ-ი	dichtbehaart
ცოლმრავალ-ი	polygam
ღუაწლმრავალ-ი	unermüdlich
ფერმრავალ-ი	verschiedenfarbig
გამომრჩევალ-ი	auslesend, auswählend
მგორვალ-ი	rollend
მკაწრვალ-ი	zerkratzend, ritzend
თანამზრახვალ-ი	ratend, beratend
ძლითმზრახვალ-ი	stotternd
კეთილისმზრახვალ-ი	zum Guten ratend
ძჳრისმზრახვალ-ი	Böses / Schlechtes wünschend / beabsichtigend
სიტყჳსმზრახვალ-ი	kunstvoll sprechend, redend
თანამძრახვალ-ი	ratend, beratend
მოტრფიალ-ი	begehrend, liebend
კრხიალ-ი	Schreien, schreien
მრეკალ-ი	klopfend
დამღულალ-ი	zerrissen, zerfetzt
იღუნალ-ი	gebogen
მალემწერალ-ი	schnell schreibend
მომაშურალ-ი	betrübt; hergekommen, eingetroffen
ტანმრგუალ-ი	dick, fett
წუერმრგუალ-ი	rundbärtig
მრავალთუალ-ი	aufmerksam
ჩიტისთუალ-ი	Anmerkungszeichen (gramm.)
ცხჳრმაღალ-ი	langnasig
ასურებლ-ი	assyrisch
მგებებელ-ი	empfangend
ღმრთისმსახურებისმნებებელ-ი	nach dem Glauben strebend
თუალთსაგებელ-ი	ansehnlich
წინაგანსაგებელ-ი	festzulegend
სირცხჳლისსაგებელ-ი	schändlich
შურისსაგებელ-ი	zu rächend
მომძაგებელ-ი	hassend
მგებელ-ი	gründend, schaffend, opfernd
სიტყჳსმიმგებელ-ი	antwortend
წარმგებელ-ი	ausgebend, verbrauchend
სიტყჳსმგებელ-ი	antwortend, streitend
წინაგანუგებელ-ი	unbedacht
შემმზადებელ-ი	bereitend, zubereitend
წინაგანმმზადებელ-ი	vorbereitend
წინამოუმზადებელ-ი	unvorbereitet
მაქადებელ-ი	drohend
მრავალსაღაღადებელ-ი	viel zu redend, einzuladend
უდიდებელ-ი	mißachtet
მრიდებელ-ი	meidend
ურიდებელ-ი	unverschämt; unverschämt
წინადამდებელ-ი	hinlegend, gebend
ანდერძისდამდებელ-ი	der ein Vermächtnis niederlegt
დამწინდებელ-ი	sich verlobend; ein Pfand gebend
მლოდებელ-ი	wartend
მოუმშჳდებელ-ი	unbezähmbar
მფრთეებელ-ი	fliegend
უზავებელ-ი	unvermischt
მოუზავებელ-ი	unvermischt, unangemessen
შემასწავებელ-ი	zeigend, verheißend, lehrend
წინამომასწავებელ-ი	im voraus anzeigend / ankündigend
მოსასწავებელ-ი	anzukündigend, anzuzeigend
მიმომაზრუნვებელ-ი	belästigend
შემაურვებელ-ი	belästigend, behindernd
აღსაშურვებელ-ი	beneidenswert
მასიძვებელ-ი	verderbend
მმიზეზებელ-ი	beschuldigend
თანადამაკუეთებელ-ი	niederwerfend, vernichtend
ქუედამაკუეთებელ-ი	hinabschmetternd
შემანივთებელ-ი	vereinigend
წასამართებელ-ი	zu machend, zu bewerkstelligend; zu machend, zu bewerkstelligend
წარმმართებელ-ი	auf den rechten Weg führend, den rechten Weg weisend
წარუმართებელ-ი	erfolglos, glücklos, sieglos
ჴელითსაძიებელ-ი	zu suchend, zu ertastend
ღონისმეძიებელ-ი	List betreibend, erstrebend
დაუგლახაკებელ-ი	nicht verarmt
მოუმკებელ-ი	ungemäht
მცვალებელ-ი	tauschend, wechselnd
მიმცვალებელ-ი	ortsverändernd, ortswechselnd
მომცვალებელ-ი	herbringend, herführend
ადგილისმცვალებელ-ი	umgesiedelt, fortgegangen
ფერისმცვალებელ-ი	verwandelnd
მაბრალებელ-ი	beschuldigend, anklagend
მოსამადლებელ-ი	zu Dank verpflichtend, für sich zu gewinnend
მიმმადლებელ-ი	schenkend, vermachend
მომმადლებელ-ი	verleihend, schenkend
წარმოუცარიელებელ-ი	unausleerlich, voll, unversiegbar,; unausleerlich, voll, unversiegbar, unerschöpflich
განმასულნელებელ-ი	Duft verströmend
განმასურნელებელ-ი	Duft verströmend; Duft verströmend
წარმომავლებელ-ი	umkreisend, umgrenzend, herumführend
თავისგანმმართლებელ-ი	sich rechtfertigend
წარსაბრკოლებელ-ი	behindernd, störend
მიუგულებელ-ი	unverständlich, unverstehbar
მოსასთულებელ-ი	zu pflückend
შემამწიკულებელ-ი	verunreinigend, beschmutzend, entehrend
შესამწიკულებელ-ი	zu beschmutzend, zu besudelnd
შეუმწიკულებელ-ი	unbeschmutzt, rein
შეუმწინკულებელ-ი	unbeschmutzt, rein; unbeschmutzt, rein
შემასრულებელ-ი	vollendend, vervollkommnend
უიძულებელ-ი	ungezwungen, ohne Zwang, freiwillig
შემაუღლებელ-ი	verbindend, verknüpfend
თანაშესაუღლებელ-ი	zu vereinigend
მიუახლებელ-ი	fern
მოუბრყჳლებელ-ი	nicht erschlafft
წინამწამებელ-ი	ankündigend, im voraus anzeigend
ცილისშემწამებელ-ი	verleumdend
საჰამებელ-ი	angenehm
შესაყვანებელ-ი	hineinzubringend
მისაყვანებელ-ი	hinzuführend, wegzuführend
მოსაყვანებელ-ი	herzubringend, herzuführend
შთამყვანებელ-ი	hinabführend
შემყვანებელ-ი	hineinbringend, hineinführend
მიმყვანებელ-ი	hinführend, wegführend
მომყვანებელ-ი	herbringend
ზედამომყვანებელ-ი	herbringend, herschaffend
შთამომყვანებელ-ი	herabführend
წინამომყვანებელ-ი	herbringend, vorstellend
შემომყვანებელ-ი	hereinführend
მიმომყვანებელ-ი	her- und wegtragend
შემნანებელ-ი	bereuend
მომტანებელ-ი	herbeibringend
მისაძღუანებელ-ი	abzusendend, zu überreichend
მიმძღუანებელ-ი	sendend, absendend
შემაჴსენებელ-ი	erinnernd
მომაჴსენებელ-ი	erwähnend, erinnernd, sich erinnernd
აღსაჴსენებელ-ი	zu erinnernd, zu gedenkend
ნათესავმოუჴსენებელ-ი	nichtverwandt
განმაშუენებელ-ი	verschönernd
თითისსაჩუენებელ-ი	mit dem Finger daraufzuzeigend, zu rügend
მატკივნებელ-ი	Schmerz verursachend
მტკივნებელ-ი	schmerzend, Schmerzen zufügend
მომვნებელ-ი	vernichtend
საჰამოვნებელ-ი	angenehm
მოსაპოვნებელ-ი	zu findend, zu erlangend
საწოვნებელ-ი	zu saugend
პირუთნებელ-ი	unvoreingenommen, unparteiisch
წარმომადგინებელ-ი	aufdeckend, entlarvend
შესადგინებელ-ი	entsprechend, hinzuzufügend
შესადრგინებელ-ი	entsprechend, hinzuzufügend
შესადრგინებელ-ი შესადრგინებელ-ი	entsprechend, hinzuzufügend
აღმომადინებელ-ი	herausfließend, herausströmend
მოულოდინებელ-ი	unerwartet
მოსაკუდინებელ-ი	zu tötend
მავლინებელ-ი	entsendend
წარმომავლინებელ-ი	herschickend
წარმავლინებელ-ი	wegschickend
წარმოსავლინებელ-ი	herzuschickend
წარსავლინებელ-ი	wegzuschickend
საშინებელ-ი	Furcht einflößend
წარმომაჩინებელ-ი	offenbarend
წარმოსაჩინებელ-ი	zu offenbarend, zu zeigend
თანაჯერმჩინებელ-ი	einverstanden, gemeinsam festlegend
ჯერისმჩინებელ-ი	als nötig erachtend
თანაჯერისმჩინებელ-ი	einverstanden, gemeinsam festlegend
შემძინებელ-ი	hinzufügend
საძაგელისშემძინებელ-ი	übermäßig gierig
მქორწინებელ-ი	(eine Frau) heiratend
მომაგონებელ-ი	eingebend, beeinflussend
თანასაგონებელ-ი	überlegung
შესაგონებელ-ი	zu unterrichtend, zu unterweisend
ძნელსაგონებელ-ი	schwer zu denkend
სირცხჳლსაგონებელ-ი	als schändlich zu betrachtend
უძლურსაგონებელ-ი	als kraftlos / krank zu geltend
უგუნურსაგონებელ-ი	für dumm zu erachtend
მამონებელ-ი	versklavend, zum Diener machend
დამამონებელ-ი	versklavend, unterjochend
ქუედამაღონებელ-ი	hinabbiegend
მომღონებელ-ი	bewerkstelligend, zuwegebringend
მოუღონებელ-ი	unvorstellbar
შემაცთუნებელ-ი	verleitend, verführend
შესაცთუნებელ-ი	zu verführend
მფუფუნებელ-ი	betreuend, umsorgend, verwöhnend
მოულიქნებელ-ი	durch Schmeicheleien nicht zu täuschen
სახისმაოცნებელ-ი	vortäuschend
მაშჱნებელ-ი	bauend, erbauend
უშჱნებელ-ი	unbewohnt
მარცხჳნებელ-ი	beschämend
მდროებელ-ი	verspäten lassend, zu spät kommen lassend, sich verspätend
მსაშოებელ-ი	empfangend
განმჴმარებელ-ი	nutzend, gebrauchend
მოსაწყნარებელ-ი	zu begradigend, geradezumachend, zu ebnend
ღმრთისშემწყნარებელ-ი	gottgläubig, gottbekennend
თანადშემყუარებელ-ი	sich verliebend
განმაცჳბრებელ-ი	erstaunlich
განსაცჳბრებელ-ი	um den Verstand bringend, verrückt machend
მომამედგრებელ-ი	faul / träge machen
მოუმედგრებელ-ი	unerschütterlich
შემკადრებელ-ი	wagend
შემვედრებელ-ი	flehend, bittend
თანადაუხუედრებელ-ი	abwesend
უბგერებელ-ი	unerregt, ruhig
მოსალმობიერებელ-ი	zu tröstend
წარმოუცალიერებელ-ი	unausleerlich, voll, unversiegbar, unerschöpflich
შესამეცნიერებელ-ი	zu erkennend, zu erfahrend
შემანაწევრებელ-ი	vereinigend
შეუნაწევრებელ-ი	unverknüpft, unverbunden
მოუმდოვრებელ-ი	unbezähmbar; unbearbeitet
განმაზღვრებელ-ი	teilend, trennend
განმასაზღვრებელ-ი	festlegend, trennend
წინაგანმსაზღვრებელ-ი	festlegend
შეუსაზღვრებელ-ი	unumgrenzt, unbegrenzt
მოუნადირებელ-ი	frei
უჭირებელ-ი	leicht, gefahrlos
წიაღშემკრებელ-ი	versammelnd
მრჩობლგანმსტუმრებელ-ი	reich bewirtend
საცხორებელ-ი	Besitz, Habe, Lebensunterhalt, zu erlösend
მცხორებელ-ი	lebend
მომაუძლურებელ-ი	schwächend
სამოძღურებელ-ი	zu lehrend
მმსახურებელ-ი	verwendend, benutzend
შემაიწრებელ-ი	belästigend, behindernd
შეუიწრებელ-ი	unbelästigt
მამსგავსებელ-ი	ähnlich machend, angleichend
აღმვსებელ-ი	füllend
შემათჳსებელ-ი	annehmend
მჭეშმარიტებელ-ი	wahrheitssagend, wahrhaftig; wahrheitssagend, wahrhaftig
განსაოტებელ-ი	zu verjagend, zu vertreibend
მბოროტებელ-ი	böse
მოუნესტუებელ-ი	widerspenstig, ungehorsam
სასყიდლისმომატყუებელ-ი	bezahlend, entgeltend
თანაშესატყუებელ-ი	entsprechend
მაეჭუებელ-ი	mißtrauenerweckend
მმარჯუებელ-ი	geschickt, könnend
განსაჴუებელ-ი	wegzunehmend
განუჴუებელ-ი	ungemindert
მომნაყოფებელ-ი	machend, tuend
განუქიქებელ-ი	tadelsfrei
მისაღებელ-ი	hinzutragend, wegzunehmend
მოსაღებელ-ი	herzubringend
მიმოსაღებელ-ი	hin- und herzubringend
ნაყოფისგამომღებელ-ი	fruchtbringend
შემომღებელ-ი	hereinbringend, hereinschaffend
მიმომღებელ-ი	hin- und hertragend
წარმღებელ-ი	wegnehmend, raubend
განსაძღებელ-ი	zu sättigend
უმრუშებელ-ი	weniger hurend
წარმატაცებელ-ი	entführend, raubend
მიმომტაცებელ-ი	verwüstend, verheerend, zerstörend
მიმოუტაცებელ-ი	ganz, ungeteilt
მფიცებელ-ი	schwörend
მტყორცებელ-ი	werfend
უანდერძებელ-ი	testamentlos, im Testament nicht bedacht
მომანიჭებელ-ი	schenkend, verleihend
სასყიდლისმომნიჭებელ-ი	bezahlend, entgeltend
ჴელითშესახებელ-ი	mit der Hand zu berührend
შეურაცხებელ-ი	unzählig
მცხებელ-ი	salbend, einreibend; verleihend
შესაგბობელ-ი	zu kochend
შემტკბობელ-ი	annehmend, aufnehmend
დამტეობელ-ი	zurücklassend, dalassend
აღმტეობელ-ი	herauf-, hervor-, herauslassend
მმიზეზობელ-ი	beschuldigend; beschuldigend
აღსამსთობელ-ი	früh aufzustehend
მაგიობელ-ი	schimpfend
მამკობელ-ი	schmückend
უმკობელ-ი	ungeschmückt, häßlich
მრავალსაგალობელ-ი	sehr zu preisend
თანამგალობელ-ი	gemeinsam singend
მმადლობელ-ი	dankend, dankbar
მსამართლობელ-ი	streitend, klagend
უჩრდილობელ-ი	schattenlos
საეჭუ-საცილობელ-ი	strittig
უსაცილობელ-ი	unstrittig
მლობელ-ი	schmerzend, Schmerzen habend
მალმობელ-ი	schmerzend, belästigend
მომალმობელ-ი	lindernd, heilend
განმაჴმობელ-ი	welken lassend
ზედდამჴმობელ-ი	rufend, schreiend
მიუყრდნობელ-ი	aufrecht, ohne anzulehnen
შემაცნობელ-ი	begreifend, verstehend
წინამცნობელ-ი	im voraus erfahrend / erkennend
წინაჲსწარმცნობელ-ი	vorauserfahrend, vorauserkennend
თანამძნობელ-ი	zusammen musizierend
წინამაგრძნობელ-ი	vorausahnend, vorausfühlend
მპატიჟობელ-ი	bestrafend, strafend
მჰამრობელ-ი	zählend, auflistend
მშორობელ-ი	fern; fern
წინადამპყრობელ-ი	schützend, verteidigend
ჴელისამპყრობელ-ი	helfend, unterstützend; helfend, unterstützend
მიმპყრობელ-ი	zugewandt, opfernd
ძღუნისმიმპყრობელ-ი	schenkend, Geschenk überreichend
მადლისმპყრობელ-ი	dankbar
ჴელისაღმპყრობელ-ი	helfend, unterstützend
სიტყუადაუპყრობელ-ი	geschwätzig
გარდაუპყრობელ-ი	ununterbrochen
მსწრობელ-ი	überholend, zuvorkommend
წინამსწრობელ-ი	vorausgehend, überholend
წინაგანმსწრობელ-ი	einholend, erreichend
საჭჳრობელ-ი	anzusehend
შეულტობელ-ი	undurchnäßt
მატფობელ-ი	wärmend
სატფობელ-ი	wärmend, heizend
შემაწყობელ-ი	zusammenstellend, verfassend
პირველადმშობელ-ი	Mutter, die ihr erstes Kind gebiert
მარჩბივთმშობელ-ი	zwillingsgebärend
დიდებისმბორგელ-ი	ruhmsüchtig, ehrgeizig
თივისმბორგელ-ი	grasüberwachsen
მოსახადელ-ი	einzuberufend, einzuladend
ოთხკედელ-ი	vierwändig
უწმედელ-ი	ungereinigt
შემბნედელ-ი	ohnmächtig werden lassend
მოსაწყუედელ-ი	auszurottend, zu vernichtend
მზდელ-ი	ernährend, aufziehend; ernährend, aufziehend
დიდძალისსასყიდელ-ი	teuer
მოუსყიდელ-ი	ungekauft
შრანდელ-ი	vorjährig
დღენდელ-ი	heutig
მკოდელ-ი	schneidend, hauend, abtrennend
შვილთმზრდელ-ი	kindererziehend
სიტყჳსმიმჴდელ-ი	Rechenschaft fordernd, vernehmend
თანაწარმჴდელ-ი	beseitigend
უნერგველ-ი	ungepflanzt
მისახედველ-ი	zu sehend, zu erblickend
შთამხედველ-ი	hinabblickend
წინამხედველ-ი	vorauserkennend, voraussehend
მძიმედმხედველ-ი	schlecht sehend
მრუმედმხედველ-ი	schlecht sehend
მალემხედველ-ი	scharf sehend
ქუედამზიდველ-ი	hinabziehend
შთამზიდველ-ი	hinabziehend, hinabzerrend
დასაბეჭდველ-ი	zu siegelnd, zu bestätigend
მაზღვეველ-ი	bezahlen lassend
საკულეველ-ი	zu untersuchend, zu suchend
გამომკულეველ-ი	erforschend, untersuchend
უგამოუკულეველ-ი	unerforschlich
განულეველ-ი	ständig, fortwährend; ständig, fortwährend
მათქუმეველ-ი	sprechen lassend
მჴუმეველ-ი	benutzend, gebrauchend
არმჴუმეველ-ი	nicht verwendend
მიმოდამაბნეველ-ი	umherstreuend
მიმოდასაბნეველ-ი	zu verstreuend
მიმოგანუბნეველ-ი	unteilbar
მიმთრეველ-ი	wegzerrend
შემრეველ-ი	durcheinanderbringend, vermischend
ურეველ-ი	unvermischt
შემაცურეველ-ი	verringernd, vermindernd
შემამრღუეველ-ი	durcheinanderbringend, Aufruhr stiftend
შესამრღუეველ-ი	durcheinanderzubringend
შემამთხუეველ-ი	entgegenbringend
ძჳრისშემამთხუეველ-ი	Böses bereitend
მისამთხუეველ-ი	zu begegnend, zu findend
შეუმთხუეველ-ი	kampflos, unbekämpfbar
საწყეველ-ი	zu verfluchend
განმრჩეველ-ი	auswählend
ურჩეველ-ი	unrein
მიმაქცეველ-ი	umkehren lassend, wegführend, hinführend
გარემიმაქცეველ-ი	umdrehend, umwendend, sich abwendend
გარდასაქცეველ-ი	zu verführend
მიმოსაქცეველ-ი	zu drehend, zu wendend
გარეშეუქცეველ-ი	direkt
განსათხეველ-ი	wegzuwerfend, zu vertreibend
წარსათხეველ-ი	zu verschüttend
უხეველ-ი	ganz, unzerrissen
უთხზველ-ი	ungeflochten
შეუშფოთველ-ი	ruhig, friedlich
ზედადასართველ-ი	hinzufügend
ზედადამრთველ-ი	darauflegend, hinzufügend
განუწურთველ-ი	unbestraft
ღმრთისმტჳრთველ-ი	gläubig
უმურკველ-ი	ungesäubert, ungestärkt, ungewalkt; ungesäubert, ungestärkt, ungewalkt
ულალველ-ი	ruhig, still
ჭამისმმალველ-ი	heimlich essend
მიუთუალველ-ი	unannehmbar, unvereinbar
აღუთუალველ-ი	unzählig
მომნათლველ-ი	taufend
წინაგანმხილველ-ი	berücksichtigend, vorhersehend
კეთილადგანმხილველ-ი	sich gut auskennend
მომხილველ-ი	sehend, betrachtend, umhergehend (Priester)
ღმრთისმხილველ-ი	gottsehend
გემოჲსუხილველ-ი	hungrig
თუალითმკლველ-ი	mit dem Blick tötend
განუვლთოლველ-ი	unteilbar
უკუმოლველ-ი	ohne Rauch, ungeräuchert
სალტოლველ-ი	zu meidend, zu vermeidend
სავლტოლველ-ი	zu fliehend, zu meidend
მლტოლველ-ი	geflohen, fliehend
დაულტოლველ-ი	trocken
მქოლველ-ი	steinigend
მფლველ-ი	beerdigend, bestattend, begrabend
შთამფლველ-ი	eingrabend, vergrabend
მომწყლველ-ი	verwundend
უწყლველ-ი	unversehrt, unverwundet
მოუწყლველ-ი	unverwundet
თანამბრდღუენველ-ი	zürnend
სატყუენველ-ი	gefangengenommen
წარსატყუენველ-ი	zu entführend, zu raubend
წარმომტყუენველ-ი	verwüstend, verheerend
წარუტყუენველ-ი	unentführbar, geschützt, bewahrt, unverwüstlich
გასაკუთნველ-ი	gliedernd (grammat.)
განმკუთნველ-ი	sich aneignend
შუვაგანმფრინველ-ი	in der Mitte fliegend
მურკნველ-ი	weiß machend; weiß machend
მმურკნველ-ი	weiß machend
უმურკნველ-ი	ungesäubert, ungestärkt, ungewalkt
მრავალსაზრუნველ-ი	sehr fürsorgend
წკერათამნიშნველ-ი	Hellseher (?)
აღმნიშნველ-ი	bezeichnend
სასტჳნველ-ი	zu tadelnd, zu verurteilend, zu mißbilligend
წინამიმათხოველ-ი	verheiratend
მიმთხოველ-ი	zur Frau nehmend
გამომთხოველ-ი	Bittsteller, bittend
წარსაპარველ-ი	zu stehlend
მიმპარველ-ი	Dieb, stehlend
წარუპარველ-ი	ungestohlen, unstehlbar
მომბერველ-ი	wehend, verleihend
განსაწირველ-ი	verloren, unrettbar
ჟამისმწირველ-ი	Messe lesend
უწირველ-ი	nicht opfernd / geopfert
შეუწირველ-ი	unannehmbar; unannehmbar
მრავალსაჭირველ-ი	sehr betrüblich
შემკრველ-ი	bindend, fesselnd, hindernd
შემმუსრველ-ი	vernichtend
შეუმუსრველ-ი	unzerschlagbar, unzerstörbar
აღმტრველ-ი	hervorrufend, erweckend
ზედდამბურველ-ი	bedeckend, verhüllend
უბურველ-ი	unverhüllt
წინააღმჭურველ-ი	(sich) zum Widerstand / Kampf rüstend
შესახურველ-ი	zuzudeckend, zu bedeckend
მძრველ-ი	anstachelnd, aufhetzend, schüttelnd
აღმლესველ-ი	vorbereitend
მქუსველ-ი	machend, webend
გამოსახატველ-ი	auszudrückend
უხატველ-ი	nicht dargestellt, nicht zum Ausdruck gebracht
სანერწყუველ-ი	anzuspuckend
შიშუველ-ი	nackt; nackt
მრგულიადდასაწუველ-ი	ganz zu verbrennend, ganz zu opfernd
შესაწუველ-ი	zu verbrennend
მწუველ-ი	verbrennend, brennend
დამწუველ-ი	verbrennend
შეუწუველ-ი	unverbrannt
აღსარიცხუველ-ი	zu zählend
მნერწყველ-ი	spuckend, speiend
მომრწყველ-ი	bewässernd
შესაცველ-ი	umfassend
ხილისმცველ-ი	Obsthüter, öbster
მრავალსალოცველ-ი	sehr zu erflehend
თანამლოცველ-ი	gemeinsam betend
საბაძველ-ი	nachzuahmend
აღსაბაძველ-ი	nachahmenswert
ძლითმზრახველ-ი	stotternd; stotternd
წინაგამომსახველ-ი	im voraus ausdrückend / zeigend
მოსაკითხველ-ი	zu grüßend
მართლმმარხველ-ი	ständig fastend
სიწმიდისმმარხველ-ი	rein, sich rein haltend
შემრაცხველ-ი	dafürhaltend; dafürhaltend
მოსაკიცხველ-ი	zu tadelnd, zu verspottend, zu beschimpfend
წმიდათმგოზელ-ი	Heiligtümer verbergend
მომგოზელ-ი	verputzend, verschmierend, verkittend
გარდამკუეთელ-ი	verbietend
მომკუეთელ-ი	abschneidend, abtrennend, scharf, vertreibend
წარმკუეთელ-ი	vernichtend
წინადაუცუეთელ-ი	unbeschnitten
განსაწურთელ-ი	zu erziehend, zu bestrafend
წინამწურთელ-ი	trainierend, lehrend
მდურვიელ-ი	unzufrieden, übelnehmend, schmollend
ცოხნიელ-ი	wiedergekäut
მადრიელ-ი	dankbar; dankbar
მოსაქციელ-ი	umzudrehend, umzukehrend
მოსადრეკელ-ი	zu unterwerfend
მიმდრეკელ-ი	umbiegend, abbiegend, auf seine Seite ziehend
უზელელ-ი	ungeknetet, nicht weichgemacht
მრგულისმომვლელ-ი	ringsherumgehend, rundherumtanzend
წიაღმვლელ-ი	überquerend
თანამყოლელ-ი	mitreisend, begleitend
მიმყოლელ-ი	folgend, glaubend
თანამიმყოლელ-ი	folgend
თანააღმყოლელ-ი	folgsam, gehorsam
უძრწოლელ-ი	furchtlos
უსარჩლელ-ი	unbestreitbar
წარმომცლელ-ი	leerend, ausleerend
მაჭამელ-ი	essen lassend
უგბილმჭამელ-ი	Rohesser, grausam
თივისმჭამელ-ი	weidend, grasfressend
თელგმისმჭამელ-ი	eiterbeseitigend
ფერჴისწარსადგმელ-ი	zu schreitend, den Fuß zu setzend
განმდგმელ-ი	hinausschaffend, hinausbringend, hinausführend
მგურემელ-ი	schlagend
განმგურემელ-ი	verwundend, tötend
წასაცემელ-ი	wegzuschickend; wegzuschickend
განსაცემელ-ი	auszugebend, wegzugebend
პატივისსაცემელ-ი	zu verehrend
ნუგეშინისსაცემელ-ი	zu tröstend
ფერჴისსაცემელ-ი	mit dem Fuß zu tretend
გზამცემელ-ი	zulassend, zulässig
წინამიმცემელ-ი	im voraus gebend
სასყიდლისმიმცემელ-ი	bezahlend
წინაგანმცემელ-ი	im voraus gebend
ზეგარდამომცემელ-ი	vom Himmel gebend
წარმომცემელ-ი	herschickend, hergebend
ცხორებისმომცემელ-ი	belebend, lebensspendend
მადლისმცემელ-ი	dankbar
თავყანისმცემელ-ი	verehrend
ნუგეშინისმცემელ-ი	tröstend
უგლიმელ-ი	unverschämt, närrisch; unverschämt, närrisch
მოსადგომელ-ი	zu umschließend, zu umzingelnd, einzuschließend
განსავრდომელ-ი	zu ändernd, zu übertretend
შეუვრდომელ-ი	nicht gefallen
თანადაუხდომელ-ი	abwesend
ზედამჯდომელ-ი	oben sitzend
თანამჯდომელ-ი	dabeisitzend
საჴდომელ-ი	strittig, umstritten
თანაწარსაჴდომელ-ი	mißachtend
თანაშემზომელ-ი	sich auf eine Seite stellend
შეუზომელ-ი	unermeßlich
ძალგანუზომელ-ი	unermeßlich stark
შესაცთომელ-ი	sich irrend, fehlgehend
შემცთომელ-ი	gefehlt, sich irrend
მისაწთომელ-ი	erreichbar, verständlich
მიმწთომელ-ი	begreifend, verstehend; begreifend, verstehend
დაუჭნომელ-ი	unverwelkt; unverwelkt
წინადამდგრომელ-ი	aushaltend, Widerstand leistend
მშურომელ-ი	arbeitend, machend, die Notleidenden versorgend
თანაშემცხრომელ-ი	zusammen die Zeit vertreibend
განუცხრომელ-ი	ruhelos
განსაძღომელ-ი	zu sättigend
დაურჩომელ-ი	nicht übriggeblieben
მისართუმელ-ი	zu überreichend, zu schenkend
მოსართუმელ-ი	zu überreichend
ნაყოფთმრთუმელ-ი	versprechend, anbietend
შემომრთუმელ-ი	hereinbringend, hereinschaffend
სისხლისმსუმელ-ი	blutrünstig
სათქუმელ-ი	zu sagend, zu sprechend
გამოსათქუმელ-ი	auszusprechend; zu erklärend
მიმოდამთქუმელ-ი	Nachricht verbreitend
სულთმთქუმელ-ი	belästigend, störend
წარმომთქუმელ-ი	sprechend, sagend
წინაწარმომთქუმელ-ი	vorhersagend
გამოუთქუმელ-ი	unaussprechlich
ზედამრქუმელ-ი	von oben bedeckend, verhüllend
შეურწყუმელ-ი	unvereint
ჯუარისმცუმელ-ი	kreuzigend
მიმხუმელ-ი	nehmend, aufnehmend, wegnehmend
გამომხუმელ-ი	herausholend, herausbringend
სარტყლისშემრტყმელ-ი	Gürtel umschnallend (sich auf den Kampf vorbereitend)
უგბილსაჭმელ-ი	roh zu essend
კეთილსაჭმელ-ი	eßbar
ზედდასასხმელ-ი	umzuhängend, überzuziehend
ზედმოსასხმელ-ი	umzuhängend, überzuziehend
შვილთმსხმელ-ი	kinderhabend
ორთმსხმელ-ი	Zwillinge gebärend
გუერდგანმჴმელ-ი	seitengelähmt
გამბანელ-ი	waschend; waschend
მტკებნელ-ი	stampfend
ეგჳპტებნელ-ი	ägyptisch
უცებნელ-ი	nicht begreifen könnend
მოსაბრადნელ-ი	umzulegend, zu umhüllend; umzulegend, zu umhüllend
მჴუედნელ-ი	schlagend, stoßend, prügelnd
წარმვლენელ-ი	fortschickend
მოსათმენელ-ი	zu ertragend, zu erduldend
უსმენელ-ი	ungehorsam; ungehorsam
მიმომფენელ-ი	verbreitend (Nachricht)
წარსაგზავნელ-ი	zu verschickend
წარმმგზავნელ-ი	wegschickend, vertreibend; wegschickend, vertreibend
წარმგზავნელ-ი	wegschickend, vertreibend
შეურევნელ-ი	unvermischt, rein
მიმაწევნელ-ი	hinführend, hinbringend
მომაწევნელ-ი	herbringend, herschaffend
მისაწევნელ-ი	erreichbar, verständlich
წინამწევნელ-ი	helfend
შემწევნელ-ი	helfend, unterstützend; helfend, unterstützend
მიმწევნელ-ი	erreichend, hinführend
მიუწევნელ-ი	unverständlich
უპოვნელ-ი	verloren
უთხზნელ-ი	ungeflochten
მრავალსადინელ-ი	vieladrig
სასიკუდინელ-ი	Todes-, tödlich
ნიშანსაშინელ-ი	unheilverkündend
უკანაჲსკნელ-ი	letzter; letzter
უკუანაჲსკნელ-ი	letzter
უუკუანაჲსკნელ-ი	folgender, nächster
შეუზმნელ-ი	unwissend
უჩინოსაქმნელ-ი	zu vernichtend
შვილთმქმნელ-ი	kinderzeugend
ვერშვილთმქმნელ-ი	impotent
ჭეშმარიტმქმნელ-ი	wahr machend
შეუქმნელ-ი	ungeboren, ungeschaffen, ungezeugt
ჴელითუქმნელ-ი	nicht von Hand geschaffen
საჯმნელ-ი	zu entfernend, zu erledigend
მჯმნელ-ი	entfernend, sich entfernend
საგონელ-ი	zu bedenkend, anzunehmend
უცონელ-ი	fleißig; fleißig
თანააღმწონელ-ი	vermischt
მწმასნელ-ი	zusammenstellend, verwirrend
მიმომრღუნელ-ი	übertretend, überschwemmend
წარურღუნელ-ი	ungetrübt
ურყუნელ-ი	unverwest, unvergänglich
მლიქნელ-ი	schmeichelnd
უქმმქნელ-ი	unfruchtbar machend
უხწნელ-ი	unverderblich
უჴწნელ-ი	unverderblich
მღულარჭნელ-ი	in Schlangenlinien gehend
მწიხნელ-ი	einen Tritt gebend
უვარცხნელ-ი	ungekämmt
მქენჯნელ-ი	peinigend, quälend
მქსოელ-ი	webend
მიმთხოელ-ი	zur Frau nehmend; zur Frau nehmend
ტყრპელ-ი	flach
ფურცელტყრპელ-ი	flachblättrig
დამღუარელ-ი	vergießend, verschüttend
შთასაწერელ-ი	niederzuschreibend
გარეშეუწერელ-ი	grenzenlos
ზედაწარუწერელ-ი	ohne überschrift
გარეშეუსაზღვრელ-ი	grenzenlos
მიმგურელ-ი	hinbringend, hintragend, hinführend
აღმომფხურელ-ი	herausreißend
მყრელ-ი	wegwerfend, emporwerfend
მიმოდამყრელ-ი	umherstreuend
მრჩობლშთასაჭრელ-ი	heimtückisch
საგლესელ-ი	zu bestreichend
მყნოსელ-ი	riechend, schnuppernd
მსხუერტელ-ი	zerreibend
მწერტელ-ი	stechend
საზაკუელ-ი	hinterlistig, heimtückisch
იგავითმეტყუელ-ი	in Gleichnissen redend
წარმომეტყუელ-ი	ankündigend
ორისმეტყუელ-ი	doppelzüngig, lügnerisch
სანერწყუელ-ი	anzuspuckend; anzuspuckend
განმძრცუელ-ი	raubend, Räuber, entfernend, beseitigend
მომძრცუელ-ი	raubend, plündernd, (Kleidung) ausziehend
აღუძრცუელ-ი	ungeöffnet
განსაკაფელ-ი	zu vernichtend
სასწრაფელ-ი	wünschenswert
მოწყალე-მყოფელ-ი	barmherzig / mitfühlend machend
წმიდამყოფელ-ი	heiligend
გზამყოფელ-ი	reisend
კმამყოფელ-ი	zufrieden
წინამყოფელ-ი	im voraus machend / tuend
უდებმყოფელ-ი	mißachtend, faul
გულსავსემყოფელ-ი	überzeugend, hoffnungsvoll
მეფემყოფელ-ი	herrschen lassend, zum Herrscher machend
სახემყოფელ-ი	edel machend
ღმერთმყოფელ-ი	vergötternd
სრულმყოფელ-ი	beendend, vollendend
უჩინომყოფელ-ი	unsichtbar machend, verbergend, vernichtend
უნაყოფომყოფელ-ი	unfruchtbar machend
საცნაურმყოფელ-ი	sichtbar machend, deutlich machend
ნებისმყოფელ-ი	Wunsch erfüllend
თავისმყოფელ-ი	verehrend
ძლევისმყოფელ-ი	siegreich
გულისხმისმყოფელ-ი	verstehend, klug
გულისჴმისმყოფელ-ი	verstehend, klug; verstehend, klug
შეურაცხისმყოფელ-ი	mißachtend
უგულებელსმყოფელ-ი	nicht einhaltend, vernachlässigend, verachtend
ცხოველსმყოფელ-ი	belebend
სიტყჳსმყოფელ-ი	Rechenschaft ablegend
საეჭუმყოფელ-ი	zu bezweifelnd
ბაგე-სქელ-ი	dicklippig
ჭუღელ-ი	gerade (Zahl)
მკერდბრტყელ-ი	breitbrüstig
სამწყელ-ი	abzurichtend, zu zähmend
დამრჩელ-ი	strafend
ზეშთაგრძელ-ი	sehr lang, überaus lang
ჴელგრძელ-ი	langarmig
ტანგრძელ-ი	großwüchsig
მოსარეწელ-ი	zu erwerbend, zu besorgend
მღუწელ-ი	fürsorgend, betreuend
ცუდსახელ-ი	falsch
შესარაცხელ-ი	zu betrachtend, dafürzuhaltend
შემრაცხელ-ი	dafürhaltend
პირფიცხელ-ი	streng
დამშჯელ-ი	strafend, verurteilend; strafend, verurteilend
ცალჴელ-ი	einarmig
წდობილ-ი	gestählt, gehärtet
აღმსთობილ-ი	früh aufgestanden
შთობილ-ი	umgekommen, erwürgt
უზმობილ-ი	ohne gegessen zu haben, ohne zu essen
თუალდაბრმობილ-ი	blind
მოყმობილ-ი	hungrig
შედნობილ-ი	verschmolzen
ზმნობილ-ი	gedacht; genannt, benannt, vorhergesagt
წინაჲსწარცნობილ-ი	vorhererkannt
დაჭნობილ-ი	verwelkt
წინამისწრობილ-ი	zuvorgekommen
მიგრძობილ-ი	lang
შებჭობილ-ი	beschlossen
წინაგანბჭობილ-ი	vorher entschieden
განფრთხობილ-ი	wach
მოლხობილ-ი	erschlafft
შებნედილ-ი	traurig
სულშებნედილ-ი	ohnmächtig
თმამოზრდილ-ი	langhaarig
თანააღზრდილ-ი	gemeinsam erzogen
ვეცხლითფრდილ-ი	mit Silber gekauft
ცდილ-ი	erfahren, erprobt
ჴდილ-ი	herausgezogen, gezückt
გჳრგჳნჴდილ-ი	der Krone verlustig
თანაწარჴდილ-ი	vom Hals geschafft
შეღობვილ-ი	umzäunt, gefangengenommen
დასკუდვილ-ი	aufgereiht, hintereinander
გარეშეზღუდვილ-ი	umfriedet, ummauert
მოზღუდვილ-ი	umfriedet, befestigt, zurückhaltend
შეშფოთვილ-ი	erregt, gereizt, betrübt
მოვლტოლვილ-ი	herbeigerannt
წარმოვლტოლვილ-ი	hergelaufen
წარვლტოლვილ-ი	weggelaufen, geflohen
მილტოლვილ-ი	hingerannt
მოლტოლვილ-ი	rasch hergekommen
გამოტკფოლვილ-ი	geborsten, geplatzt, zersprungen
ფრთხოლვილ-ი	erschrocken
განრჩულვილ-ი	verborgen
შეუღლვილ-ი	verbunden, verknüpft
თანაშეუღლვილ-ი	eng verknüpft, vereint
ძღუანვილ-ი	abgesandt; geführt
განკუთნვილ-ი	übereignet; festgelegt; charakteristisch; übereignet; festgelegt; charakteristisch
დაკონვილ-ი	zusammengebunden, zusammengewickelt
შეჭმუნვილ-ი	belästigt, betrübt
რჩუნვილ-ი	beschlagen, verziert
ძელითრჩუნვილ-ი	bretterbeschlagen
გამოქუცნვილ-ი	angeröstet, ausgelesen
დაფუძნვილ-ი	begründet, befestigt
თხოვილ-ი	verlobt
მითხოვილ-ი	verheiratet, verlobt
შეწურვილ-ი	zusammengezogen, zusammengedrückt
შეტუსვილ-ი	angesengt, verbrannt
მრავალშვილ-ი	kinderreich
შეჭმუხვილ-ი	betrübt
რუჯვილ-ი	geröstet
დარუჯვილ-ი	versengt
ტაბლაკეთილ-ი	freigebig
სასოკეთილ-ი	hoffnungsvoll
წინადაკუეთილ-ი	verschnitten
დრეკილ-ი	gebogen, gebeugt, gekrümmt
მიმოდრეკილ-ი	hin- und hergebogen, krumm
შეღრეკილ-ი	gebogen, gekrümmt
მოღრეკილ-ი	gebeugt
გამომარგლილ-ი	ausgejätet
ვლტოლილ-ი	geflohen
მიმოდავლტოლილ-ი	verstreut, geflohen
მივლტოლილ-ი	geflohen
ყოლილ-ი	habend, besitzend
თანამიყოლილ-ი	folgend
ღუწოლილ-ი	fürsorgend, gemüht, verdient, verdienstvoll
შთადგომილ-ი	hinabgestellt, hineingestellt
შედგომილ-ი	folgend, begleitend
წარმოდგომილ-ი	aufgestanden, gekommen
წარდგომილ-ი	hingegangen, vorgestellt
დადრგომილ-ი	stehengeblieben, haltgemacht; stehengeblieben, haltgemacht
შევდომილ-ი	hineingeworfen, hineingestürzt; hineingeworfen, hineingestürzt
დარდომილ-ი	niedergefallen, hinfällig, siech, übriggeblieben; niedergefallen, hinfällig, siech, übriggeblieben
შთავრდომილ-ი	hineingefallen
გარდამოვრდომილ-ი	heruntergefallen
შემოვრდომილ-ი	drinnen Obdach gefunden, hineingeraten
წარმოვრდომილ-ი	geschehen, gemacht
მირდომილ-ი	gestürzt, niedergefallen
თანადახუდომილ-ი	anwesend, antreffend
შეწყდომილ-ი	hineingezwängt, eingeschlossen; hineingezwängt, eingeschlossen
ჯდომილ-ი	gesetzt, sitzend, niedergelassen
წარმოჯდომილ-ი	aufgesetzt
მოჴდომილ-ი	gekommen, überfallen
გარდამოჴდომილ-ი	herübergekommen, herabgekommen
გარდაცთომილ-ი	verführt
ფერჴჩაცთომილ-ი	mit dem Fuß eingebrochen / eingesunken / hinabgestürzt
მოცთომილ-ი	geirrt, gefehlt
დადნომილ-ი	ausgezehrt, geschwächt
უკურჩომილ-ი	zurückgeblieben
ტკებნილ-ი	festgestampft
დატკებნილ-ი	gestampft
წარგრაგნილ-ი	umwickelt, gerollt
საცოდნილ-ი	zu lernend
მობლარდნილ-ი	umhüllt, eingewickelt
მიყრდნილ-ი	angelehnt, gestützt
მისმენილ-ი	erfahren, bemerkt
მრავალგანსმენილ-ი	berühmt
ნათელგარდაფენილ-ი	lichtbeschienen
ყუავილგარდაფენილ-ი	erblüht, blumenbedeckt, angenehm
რტოგარდაფენილ-ი	weitverzweigt
წინაგანფენილ-ი	gestellt, aufgestellt, gedeckt
მიმოგანფენილ-ი	verbreitet
ზედმოფენილ-ი	ausgebreitet
მარმარინოფენილ-ი	mit Marmor ausgelegt / belegt
წყენილ-ი	betrübt, überdrüssig
წარმგზავნილ-ი	weggeschickt
წარდევნილ-ი	vertrieben, verjagt
დატევნილ-ი	hineingepaßt
ძოვნილ-ი	betreut, behütet
წოვნილ-ი	gesäugt, aufgezogen
შეთხზნილ-ი	miteinander verflochten
ზღლარკნილ-ი	geschlängelt, gewunden
ახალთარგმნილ-ი	neu übersetzt
გამოთარგმნილ-ი	übersetzt, übertragen; übersetzt, übertragen
მძლექმნილ-ი	siegreich
გულსავსექმნილ-ი	überzeugt
პირველშექმნილ-ი	zuallererst geschaffen; zuallererst geschaffen
შემწექმნილ-ი	helfend, unterstützend
გულმწყრალქმნილ-ი	erzürnt
ობოლქმნილ-ი	verwaist; verwaist
ამოქმნილ-ი	aufgebaut, emporgebaut
აღმოქმნილ-ი	gemacht, getan
ხუროქმნილ-ი	der Zimmermann geworden ist
ნახევარქმნილ-ი	halb getan
უვარქმნილ-ი	verneint
წადიერქმნილ-ი	wünschend
შვილიერქმნილ-ი	Kinder habend
უშუერქმნილ-ი	häßlich anzusehend, schändlich
მსახურქმნილ-ი	verwendet, gebraucht, benutzt
მოყუასქმნილ-ი	befreundet
საეჭუქმნილ-ი	strittig
მამაცქმნილ-ი	manngeworden
გარდაწონილ-ი	gebogen
გესლგანწონილ-ი	vergiftet
მუცელჴსნილ-ი	Durchfall habend
შებრატნილ-ი	eingewickelt
მოგუნილ-ი	verführt, verleitet
მოგულარძნილ-ი	gewunden
ხრწნილ-ი	verdorben; verdorben
ჴრწნილ-ი	verdorben
დაცოხნილ-ი	wiedergekäut
მოქსოილ-ი	gewebt
მითხოილ-ი	verheiratet, verlobt; verheiratet, verlobt
ტყავგანბერილ-ი	angeschwollen
გუმერილ-ი	verwundet
გარეშეწერილ-ი	umgeben
ზემოწერილ-ი	oben geschrieben
გარეშემოწერილ-ი	umgrenzt, eingegrenzt
გარემოჲსწერილ-ი	rundherum geschrieben
თმაწურილ-ი	dünnhaarig
თითწურილ-ი	dünnfingerig
მოფხურილ-ი	abgerissen, weggefetzt
ძირფხურილ-ი	herausgerissen, entwurzelt
მარილყრილ-ი	salzbestreut
გარდაჭრილ-ი	abgestürzt, zerschmettert
მიმოგანჭრილ-ი	geschnitten, zerschnitten, zerplatzt
ქუეთხრილ-ი	eingegraben
ცხორებაშემოსილ-ი	lebend, errettet
ფურცელშემოსილ-ი	belaubt
ჯუარშემოსილ-ი	tiefgläubig
ვეცხლითმოსილ-ი	silberbeschlagen
ოქროჲთმოსილ-ი	vergoldet, goldbeschlagen
ხუეტილ-ი	abgeschabt, abgekratzt
ჩრჩუილ-ი	sehr klein, weich, neugeboren; sehr klein, weich, neugeboren
ქველყოფილ-ი	gut gemacht, gütig
მტერყოფილ-ი	zum Feind geworden
ბერწყოფილ-ი	früher / ehemals unfruchtbar
ნელტფილ-ი	lauwarm
დარეცილ-ი	ausgebreitet, ausgestreckt
წინამოკუეცილ-ი	beschnitten
მორეწილ-ი	erworben, gekauft
მიხუეჭილ-ი	geraubt, unterdrückt
ზარტეხილ-ი	verängstigt
უკუტეხილ-ი	zurückgebogen
ღელვააღტეხილ-ი	aufgewühlt, erregt
მკჳრცხილ-ი	zu Fuß (gehend); zu Fuß (gehend); zu Fuß (gehend); zu Fuß (gehend); rasch, schnell, tüchtig, lebendig, kräftig; rasch, schnell, tüchtig, lebendig, kräftig
დაშჯილ-ი	bestraft, gerichtet; bestraft, gerichtet
წინადაშჯილ-ი	vorbestraft
სადევისმყოლ-ი	abgerichtet, dressiert
ქმრისცოლ-ი	verheiratet
უღელთმბრძოლ-ი	sich gegen das Joch sträubend
ქუემწოლ-ი	gelähmt
საფრთხოლ-ი	Angst machend
თანამოთაულ-ი	teilnehmend
მწუბებულ-ი	besudelt, beschmiert
წინადაგებულ-ი	gedeckt, gereicht, geopfert
წინაგანგებულ-ი	vorher beschlossen / festgelegt
ახალმოგებულ-ი	neuerworben
შებორგებულ-ი	gefehlt, geirrt
პირველდაბადებულ-ი	erstgeboren
ზედადადებულ-ი	von oben daraufgelegt
წინაგანმზადებულ-ი	vorbereitet
უკუნგდებულ-ი	weggeworfen
ჴელთდებულ-ი	beschenkt, verpflichtet, beauftragt, gefangen
წინაჲსწარშეცოდებულ-ი	früher in Sünde gefallen
კეთილადშეზავებულ-ი	prächtig, gütig
თხლეშეზავებულ-ი	mit Bodensatz vom Wein vermischt; schlecht
სულშეზავებულ-ი	vom hl. Geist ergriffen
თანაგანზავებულ-ი	vermischt
ჰაერგანზავებულ-ი	klimatisch gemäßigt
შესოლვებულ-ი	naß gemacht; naß gemacht
შეჭმუნვებულ-ი	belästigt, betrübt
ფშჳნვებულ-ი	aufgeatmet
განუცხოვებულ-ი	entfremdet, abgefallen
მოგარვებულ-ი	rings umgeben, umzäunt
შთაგორვებულ-ი	hinabgerollt
შთამოგორვებულ-ი	herabgerollt
წარმოგორვებულ-ი	herausgerollt, herabgerollt
განცრუვებულ-ი	verurteilt
მართლწარმართებულ-ი	richtig gehend
თანაშეერთებულ-ი	passend, dazugehörig
მიმოცვალებულ-ი	veränderlich, beweglich
ფერცვალებულ-ი	verklärt
მიმოგანწვალებულ-ი	geteilt, getrennt
მოწრფელებულ-ი	begradigt
შეწულილებულ-ი	verkleinert, dünn geworden, betrübt
განგესლებულ-ი	vergiftet
მომრგულებულ-ი	rund, gerundet
მართლაღსრულებულ-ი	richtig vollendet
შეოფლებულ-ი	in Schweiß gebadet
მასპინძლებულ-ი	bewirtet
უზმებულ-ი	hungrig
ყვანებულ-ი	weggeschafft
თანამიყვანებულ-ი	hingebracht
სიზმრისზმანებულ-ი	träumend
წინაწარძღუანებულ-ი	vorausgeschickt
პირველმოჴსენებულ-ი	früher erwähnt
არმოჴსენებულ-ი	nicht erwähnbar, nicht zu gedenken
ცნობავნებულ-ი	verrückt
წინავნებულ-ი	früher erkrankt
ახალმოპოვნებულ-ი	neu eingeführt
წამოცჳვნებულ-ი	herausgefallen
სასყიდლითდადგინებულ-ი	eingestellt, gedungen
წინაგანჩინებულ-ი	im voraus festgelegt
წინაგამოჩინებულ-ი	im voraus erschienen
ზედადაძინებულ-ი	hinzugefügt, vermehrt
პირველდაძინებულ-ი	früh verstorben
წინამოგონებულ-ი	vorbedacht
წინაქონებულ-ი	früher besitzend
შვილმოწონებულ-ი	eine angemessene Zahl Kinder habend
შემონაზუნებულ-ი	zum Mönch geworden
დაფურძნებულ-ი	gegründet, begründet, befestigt; gegründet, begründet, befestigt
შჱნებულ-ი	erbaut, gebaut
შერცხჳნებულ-ი	beschämt
მრჩობლგანპებულ-ი	zweigespalten
თანაზიარებულ-ი	teilnehmend, verbündet
შემტკნარებულ-ი	geronnen
კეთილდაწყნარებულ-ი	still, friedlich
ღმრთივდამყარებულ-ი	von Gott bestätigt
მოცალიერებულ-ი	geleert
მიმგზავრებულ-ი	hingegangen, erreicht
შესაზღვრებულ-ი	umgrenzt, eingegrenzt
ღმრთივშეკრებულ-ი	von Gott gesammelt
განბოკრებულ-ი	aussätzig, leprakrank; aussätzig, leprakrank
ზეაღმოკრებულ-ი	herausgenommen, heraufgenommen
თანაცხორებულ-ი	zusammenlebend
მართლცხორებულ-ი	ordentlich / anständig lebend
მყოვარცხორებულ-ი	lang lebend, langlebig
მობადურებულ-ი	gefangen, auf seine Seite gezogen
კეთილწესებულ-ი	geordnet, ordentlich
გამოტორონტოსებულ-ი	herausgeschnitzt, herausgemeißelt; herausgeschnitzt, herausgemeißelt
აღბოლქუებულ-ი	brennend, angezündet
თანაშეტყუებულ-ი	angepaßt
განმტყუებულ-ი	falsch
სულშუებულ-ი	fröhlich, ausgeruht
ზეაღებულ-ი	geöffnet
მუცლადღებულ-ი	geschwängert, schwanger, trächtig
ნახევარმიღებულ-ი	halbtot
ახალნათელღებულ-ი	frisch getauft
წინადაწყებულ-ი	früherer
მოუწყებულ-ი	benachrichtigt
იდუმალტყორცებულ-ი	heimlich / verdeckt abgeschossen
შემოწებულ-ი	zusammengeklebt, eng verbunden
ღმრთივცხებულ-ი	von Gott gesegnet / gesalbt
ზეთცხებულ-ი	ölgesalbt, ölbestrichen
გარდარგულ-ი	übertragen, verbreitet
კეთილმოქადულ-ი	berühmt; Gutes versprechend
მიმოდაზიდულ-ი	hin- und hergeneigt
მართლჩაზიდულ-ი	nach unten gelassen, hinabgelassen, nach unten gebogen
ვეცხლითსყიდულ-ი	mit Silber gekauft
წყმენდულ-ი	verloren, untergegangen; verloren, untergegangen
თანამოფარდულ-ი	gemeinsam Handel treibend
წყუდეულ-ი	gefangen, eingesperrt
წდეულ-ი	eingegossen, hingereicht
ჰასაკეულ-ი	alt, groß
თანასახლეულ-ი	Familienmitglied, gemeinsam wohnend
ძმარსუმეულ-ი	der Essig getrunken hat
ჴუმეულ-ი	verwendet, benutzt; betrachtet, angesehen
მეჭუნეულ-ი	argwöhnisch
მიმოქნეულ-ი	umherlaufend, sich drehend
ზეშთაგარდარეულ-ი	übertrieben
ცნობაშერეულ-ი	verrückt
ნავღელრეულ-ი	gallevermischt
ყუავილგანრეულ-ი	geblümt
ცუარგანრეულ-ი	tauvermischt, taufeucht
თეთრგანრეულ-ი	mit Weiß vermischt, weißmeliert
მწჳრეაღრეულ-ი	schlammig
ერგასეულ-ი	fünfzig
ერგასისეულ-ი	fünfzig
შემრღუეულ-ი	durcheinandergebracht, erregt
მიმთხუეულ-ი	begegnet, gefallen, gestürzt
გარემოხუეულ-ი	geschlossen, bedeckt
ნისლშემოხუეულ-ი	nebelverhüllt
რიცხუეულ-ი	gezählt
შეწყეულ-ი	verflucht, verdammt
რჩეულ-რჩეულ-ი	bester
წარრჩეულ-ი	ausgewählt
წინააღრჩეულ-ი	erlesen, ausgewählt
სამოცეულ-ი	Sechzigstel, sechzigfach
გუერდქცეულ-ი	abschüssig
გარემიქცეულ-ი	umgewandt
უკუანქცეულ-ი	zurückgekehrt
გარემოქცეულ-ი	umgekehrt, zurückgekehrt
მიმოქცეულ-ი	gewunden, geschlängelt
ზედაგარდათხეულ-ი	überlaufend
მოწუვულ-ი	verbrannt
დათხზულ-ი	geflochten
მრავალშეთხზულ-ი	verworren, kompliziert
ოქროშეთხზულ-ი	goldvermischt
სამთხზულ-ი	dreifach geflochten
მოთხზულ-ი	geflochten
განვთულ-ი	geteilt
ზედადართულ-ი	hinzugefügt
თანადართულ-ი	hinzugefügt, einverstanden
ნათელგარდართულ-ი	lichtdurchdrungen, lichtbeschienen
მრავალსართულ-ი	vielstöckig
ოთხსართულ-ი	vierstöckig
შეკუართულ-ი	verknüpft
თანაშერთულ-ი	vereint, verbunden
ზედმორთულ-ი	hinzugefügt
პებით სთულ-ი	einzeln / stückweise gewebt
დამშჭუალულ-ი	angenagelt
შემშჭუალულ-ი	verbunden, verknüpft, durchdrungen
აღშალულ-ი	durcheinandergebracht
განკძალულ-ი	vorsichtig, behutsam, fleißig; vorsichtig, behutsam, fleißig
მოსაბლულ-ი	angeschnallt, angebunden
მცირედსწავლულ-ი	ungebildet
ღმრთივსწავლულ-ი	von Gott gelehrt
ღმრთითსწავლულ-ი	von Gott gelehrt
მრავალსწავლულ-ი	sehr gebildet
წინაგანსწავლულ-ი	belehrt
ზეხილულ-ი	geöffnet (Augen)
ძჳრხილულ-ი	Böses / Schlimmes ertragend
თანააღხილულ-ი	abgezählt
ასონაკლულ-ი	Krüppel, Invalide (dem ein Körperglied fehlt)
შესლულ-ი	hineingegangen
მოპიტლულ-ი	verputzt, verschmiert
განფიწლულ-ი	geworfelt, verheert, vernichtet
რქამეწამულ-ი	rotsprossig (Rebe)
მიმოგანბმულ-ი	verbreitet
ჯაჭუმობმულ-ი	in Ketten gelegt
დათლემულ-ი	eingeschlummert
ახლის-პირით გუემულ-ი	mondsüchtig
ღელვაგუემულ-ი	von den Wellen geschlagen
ზედადაცემულ-ი	niedergestürzt
გუელცემულ-ი	von einer Schlange gebissen
სენცემულ-ი	krank
ნუგეშინისცემულ-ი	getröstet
უნუგეშინისცემულ-ი	trostlos, verzweifelt
საშუვალდასუმულ-ი	in die Mitte gesetzt
ცოლსუმულ-ი	beweibt
თანაშეთქუმულ-ი	mitverschworen
გამოთქუმულ-ი	ausgesprochen; erzählt
ზემოთქუმულ-ი	oben erwähnt
ზემოწარმოთქუმულ-ი	oben erwähnt
წინაჲსწართქუმულ-ი	vorausgesagt, vorhergesagt
ჯუარცუმულ-ი	gekreuzigt
ჯუარსცუმულ-ი	gekreuzigt
მრავალგანთქმულ-ი	berühmt
ზედადასხმულ-ი	niedergesetzt
ნახევარსხმულ-ი	halbvoll
წარძღუანულ-ი	weggeschickt
დატკებნულ-ი	gestampft; gestampft
წარევნულ-ი	durcheinander, wirr, verrückt; durcheinander, wirr, verrückt
შერევნულ-ი	vermischt, durcheinandergebracht; vermischt, durcheinandergebracht
წუევნულ-ი	gerufen, eingeladen
შეზმნულ-ი	gelehrt, gebildet
ურჩებაქმნულ-ი	ungehorsam, unbotmäßig
მთაქმნულ-ი	vergrößert; zum Berg geworden
მოწესექმნულ-ი	Mönch / Nonne geworden
პირველშექმნულ-ი	zuallererst geschaffen
მოღუაწექმნულ-ი	fürsorgend, betreuend, arbeitend
ღმრთივქმნულ-ი	von Gott geschaffen
ნაკუერცხალქმნულ-ი	zu Glut geworden
მახლობელქმნულ-ი	angenähert, nahestehend
საცინელქმნულ-ი	ausgelacht, verspottet
შვილქმნულ-ი	adoptiert
ობოლქმნულ-ი	verwaist
ფრთოვანქმნულ-ი	begeistert
უჴმოქმნულ-ი	stumm geworden
ურწმუნოქმნულ-ი	ungläubig, ungehorsam
უცხოქმნულ-ი	entfernt
ნაცარქმნულ-ი	zu Asche geworden
მტერქმნულ-ი	feindlich geworden
ველურქმნულ-ი	verwildert
უგანმაგრებულესქმნულ-ი	stärker befestigt
დაძჳნულ-ი	aufgehäuft, angehäuft
არააღსუარულ-ი	unverunreinigt
ვეცხლისმოყუარულ-ი	Geldliebhaber, habgierig
უყუარულ-ი	hassend, hochmütig
ვეცხლისუყუარულ-ი	geldverachtend
ზედამოხარულ-ი	hocherfreut
თანამოხარულ-ი	gemeinsam erfreut
ზედმოხარულ-ი	auslachend, verspottend
უხარულ-ი	trauernd, betrübt
შთაბერულ-ი	eingeblasen, eingehaucht
შებერულ-ი	geblasen, aufgeblasen, geschmolzen
მტერულ-ი	feindlich
თანაშეკრულ-ი	verknüpft, verbunden, vereint
შთასრულ-ი	hinabgegangen
წასრულ-ი	weggegangen, vorig; weggegangen, vorig
ზესთსრულ-ი	dank himmlischer Gnade vollkommen
ფერმისრულ-ი	bleich / fahl geworden
შთამოსრულ-ი	herabgekommen, angekommen, eingetroffen
თანამოსრულ-ი	gemeinsam gekommen
ჩამოსრულ-ი	herabgekommen, angekommen, eingetroffen; herabgekommen, angekommen, eingetroffen
ახლადმოსრულ-ი	neugekommen
შემოსრულ-ი	hereingekommen
ზედაშემოსრულ-ი	gesprenkelt
ახალმოსრულ-ი	neuangekommen
წარმოსრულ-ი	hergekommen
წიაღმოსრულ-ი	herübergekommen, überquert
ნახევარსრულ-ი	halbvollendet
თანაწარსრულ-ი	vorübergegangen, fehlgegangen
წიაღსრულ-ი	hinübergegangen, überquert
წარმოტრულ-ი	mitgekommen
წარმოძრულ-ი	hergekommen, begonnen
უძრულ-ი	kraftlos, krank, schwach; kraftlos, krank, schwach
ღმრთივაღძრულ-ი	von Gott eingegeben
თესულ-ი	gesät
დათესულ-ი	gesät
შთათესულ-ი	hineingesät
მითესულ-ი	verstreut
მიმოგანთესულ-ი	verstreut
გარდალესულ-ი	poliert
შთალესულ-ი	hineingesteckt
დაკემსულ-ი	genäht, geflickt
თანაშექუსულ-ი	vereint, verbunden
ჴსულ-ი	geschlossen
მოჴსულ-ი	geschlossen
მოკაფულ-ი	abgenutzt, geschwächt
შეღუერფულ-ი	angehäuft, hingeworfen
შერტყულ-ი	gegürtet
ჴრშულ-ი	geschlossen; geschlossen
დაჴრშულ-ი	geschlossen; geschlossen
თჳთრჩულ-ი	eigenwillig, eigensinnig
ჩრჩულ-ი	sehr klein, weich, neugeboren; sehr klein, weich, neugeboren
ღმრთივდაცულ-ი	von Gott geschützt
დალეწულ-ი	zerschlagen, zerstört, zersplittert
შეძერწულ-ი	angeklebt, verschmiert, verbunden
ოქროშეძერწულ-ი	goldbeschlagen
მოძერწულ-ი	geschmückt, beschlagen, besetzt
ვეცხლმოძერწულ-ი	silberverziert, versilbert
შეზრახულ-ი	verhandelt, übereingekommen
მოზრახულ-ი	erdacht, erfunden
რისხულ-ი	zornig, wütend
აღრაცხულ-ი	gezählt
თანამოსაჯულ-ი	Kläger, klagend
საღუაწლ-ი	notwendig, zu betreuend; notwendig, zu betreuend
ნეცჳლ-ი	zerkrümelt, zermalmt
აღძრცჳლ-ი	bestohlen, geplündert
უბრძჳლ-ი	unversehrt, unverwundet
თითსხჳლ-ი	dickfingerig
ჴმამსხჳლ-ი	tiefstimmig
რაბამ-ი	wieviel; was für ein
მდგამ-ი	kräftig, muskulös
მონათმოდგამ-ი	einverstanden
სუარიმ-ი	untauglich, unbrauchbar
სამძიმ-ი	schwierig, schwer, belästigend
წინადაუდგომ-ი	unerträglich, unausstehlich
აღუდგომ-ი	gefallen, gestürzt
ზეაღუდგომ-ი	hinfällig
ინაჴით-მჯდომ-ი	am Tisch sitzend
ზედამჯდომ-ი	oben sitzend
ჰაგზომ-ი	soviel
ესეზომ-ი	soviel
მიმომცთომ-ი	geirrt, getäuscht; umherirrend
მწყრომ-ი	wütend, zornig
გამწყრომ-ი	zornig, wütend
უჭმ-ი	fastend, nicht essend
წუთისშინაგან-ი	kurzzeitig
ყოვლისაგან-ი	jeder, ein jeder
რომლისაგან-ი	wer von ihnen, einer von ihnen
რჩულისაგან-ი	Gesetzeskundiger, gesetzlich festgelegt; Gesetzeskundiger, gesetzlich festgelegt
მამისაგან-ი	väterlicherseits
ოქროჲსაგან-ი	golden
მაგათგან-ი	einer von ihnen / denen da
წლითგან-ი	von einem Jahr an
სამისაწლითგან-ი	von drei Jahren an
სამითწლითგან-ი	von drei Jahren an
ეგჳპტითგან-ი	eines von den ägyptischen
ზენაჲთგან-ი	himmlisch
თთჳთგან-ი	über einen Monat alt
შენგან-ი	deinig
მისგან-ი	einer von ihnen / denen
ამისგან-ი	sein, ihr, dessen, deren
თავქედეან-ი	wahnsinnig
ოქრევეან-ი	golddurchwirkt, vergoldet
ოქროვეან-ი	golddurchwirkt, goldbeschlagen, reich
ჭიეან-ი	wurmig
მარილეან-ი	salzig
გესლეან-ი	giftig
მატლეან-ი	wurmig
სხეულეან-ი	fleischlich
ადამეან-ი	Nachkomme Adams, Mensch, menschlich
მრავალჴმეან-ი	vielstimmig
ოქროჴმეან-ი	wohlklingend
კაეშნეან-ი	bekümmert, betrübt
ქარეან-ი	stürmisch, windig
საცთურეან-ი	falsch
მრავალსაცთურეან-ი	sehr verführerisch
ნიღურეან-ი	schmutzig
ოქრეან-ი	golddurchwirkt, vergoldet
ტყეან-ი	bewaldet
მსივან-ი	angeschwollen
მხივან-ი	eitrig
ფესანგოვან-ი	farbig, bunt
მარცულედოვან-ი	-silbig
სამშჭულედოვან-ი	Nagel-, mit Nägeln versehen
ზღვევოვან-ი	schädigend
მარჩბივოვან-ი	zwillingsgebärend
მრავალტჳრთოვან-ი	überaus schwer
ჭაბუკოვან-ი	jung
ჭრელოვან-ი	farbig, bunt
სიტყუაჴელოვან-ი	bildhaft redend
ჰავჴელოვან-ი	böse
მრავალჴელოვან-ი	sehr geschmückt, sehr geschickt
ნათლოვან-ი	hell
კეთილყუავილოვან-ი	aufgeblüht, erblüht, blühend
დიდმწუანვილოვან-ი	ergrünt
გულარძნილოვან-ი	krumm, uneben
სხეულოვან-ი	fleischlich
ძაღლოვან-ი	hundebesitzend
ღჳრღლოვან-ი	holprig, steinig, unwegsam
კეთილჩრდილფურცლოვან-ი	viel Schatten spendend, von vielen Blättern überdacht
ტჳნოვან-ი	fett
მზუაროვან-ი	sonnig
ღირღუაროვან-ი	holprig, steinig, unwegsam; holprig, steinig, unwegsam
სოროვან-ი	löchrig
სამხატოვან-ი	dreifaltig, dreigestaltig
ოთხსუეტოვან-ი	viersäulig
ძარღოვან-ი	sehnig, geädert
მჴრცოვან-ი	grauhaarig, alt; grauhaarig, alt
ანგელოზთსახოვან-ი	engelhaft
მრგულისსახოვან-ი	rund, kreisförmig
დიდრვან-ი	sehr groß; sehr groß
დიდრუვან-ი	sehr groß; sehr groß
მშუვან-ი	mit Zähnen versehen
მყვან-ი	führend, hinbringend, hinführend
მრავალშფოთიან-ი	sehr erregt
მედრეკიან-ი	biegsam
ზმურდლიან-ი	aussätzig
პირჭროფლიან-ი	sommersprossig
ნავღლიან-ი	verrückt
მარილოვნიან-ი	salzig
ოქრიან-ი	golddurchwirkt, vergoldet; golddurchwirkt, vergoldet
ვაჰმან-ი	jemand
სარწყაოან-ი	zu bewässernd
კლდოან-ი	felsig, steinig; felsig, steinig
ნათესავოან-ი	verwandtschaftlich
მორევოან-ი	strudelförmig
მოქცევოან-ი	sich drehend
თუალოან-ი	großäugig
უსასყიდლოან-ი	kostenlos, ergebnislos
ჴურელოან-ი	durchlöchert
სახელოან-ი	berühmt, namhaft; berühmt, namhaft
ყუავილოან-ი	Blumen-, erblüht, geblümt
მარილოან-ი	salzig; salzig
სხეულოან-ი	fleischlich; fleischlich
გემოან-ი	schmackhaft; schmackhaft
ჴმოან-ი	laut; laut
ზაროან-ი	furchteinflößend
წყაროან-ი	Quell-, quellengleich
კეთროან-ი	aussätzig; aussätzig
პორფიროან-ი	rot
მიწოან-ი	erden, irden; erden, irden
ამბოხოან-ი	unruhig, stürmisch
ჭანგოსან-ი	mit Krallen versehen
სპეტაკოსან-ი	weißgekleidet
შვილოსან-ი	kinderhabend
ჩაფხუტოსან-ი	behelmt
ხარჭოსან-ი	eine Nebenfrau habend
მრისხან-ი	zornig, wütend, böse
ჰაგდენ-ი	soviel
კუერცხისაოდენ-ი	eigroß
ეგეოდენ-ი	soviel
ესეოდენ-ი	soviel
მერავოდენ-ი	wievielter
მარცუალოდენ-ი	beerengroß, körnchengroß
იოტოდენ-ი	sehr klein; sehr klein
ესთენ-ი	soviel; soviel
რაჲსთენ-ი	wieviele
ამენ-ი	wahrhaftig, wahr
შენასმენ-ი	angezeigt
ქველნაბრდღუენ-ი	tapfer
ბძენ-ი	weise, klug; weise, klug
მცხოვნ-ი	lebend, lebendig
კნინ-კნინ-ი	ein wenig
პჳთონ-ი	hellseherisch
უშჱნ-ი	unbewohnt, unbesiedelt
ნახევარმგბარ-ი	halbgekocht, halbgar
ზოგსმგბარ-ი	halbgekocht
მგინებარ-ი	schimpfend, beschimpfend
მგიობარ-ი	schimpfend
მტრიობარ-ი	zügellos, hemmungslos, herumlungernd, sich herumtreibend
მწუნობარ-ი	bemängelnd
მჴჳობარ-ი	schreiend, klagend, weinend
ნიჭმდიდარ-ი	freigebig
ძლითმომკუდარ-ი	getötet, erschlagen, umgebracht
ზოგიმომკუდარ-ი	halbtot
მგებვარ-ი	empfangend
წინამგებვარ-ი	empfangend
მხედვარ-ი	sehend
მიმხედვარ-ი	ansehend, betrachtend; hoffend, auf andere vertrauend
დამზიდვარ-ი	hinabziehend
მომშევარ-ი	hungrig
შემშთვარ-ი	halbtot
მდელოჲსმძოვარ-ი	grasfressend
სახელმტყუვარ-ი	falsch, lügnerisch
მარადისმტყუვარ-ი	ständig lügend
ჩემვითარ-ი	meinesgleichen
მჴმობიარ-ი	rufend, lockend, sprechend; rufend, lockend, sprechend
ცხორებისზიარ-ი	zusammenlebend
მცემარ-ი	schlagend, beißend
კმარ-ი	genügend, genug
ერთიცოლისქმარ-ი	Mann, der nur eine einzige Frau hat
არასაჴმარ-ი	untauglich, unbrauchbar
მეუბნარ-ი	sprechend, redend
მკდნარ-ი	eingedickt, gestockt, gefroren
მღუნარ-ი	krumm, gebeugt
მჭნარ-ი	welk, verwelkt
შემჭნარ-ი	verwelkt, verdorrt
მწოარ-ი	saugend; saugend
მსხლეტარ-ი	herabstürzend, springend
კეთილისმოძღუარ-ი	Gutes lehrend
მრგულიადმწუარ-ი	ganz zu verbrennend / opfernd
ცეცხლითმომწუარ-ი	vom Feuer verbrannt
უმწუარ-ი	ungebrannt
მჭუარ-ი	unzufrieden
უმცხუარ-ი	ungebrannt
ცუდადმყეფარ-ი	unsinnig bellend
წინაჲსწარ-ი	früherer, im voraus
მექუხარ-ი	donnern lassend
საქმეთაებრ-ი	der Sache entsprechend
ჰურიაებრ-ი	jüdisch
ჰრომაებრ-ი	lateinisch; lateinisch
ჩუეულებისაებრ-ი	gewöhnlich
მსგავსებისაებრ-ი	ähnlich
ღირსებისაებრ-ი	angemessen, geeignet, entsprechend, passend
ნათესავობისაებრ-ი	artverwandt
ძალისაებრ-ი	der Möglichkeit entsprechend, erträglich
ჯერისაებრ-ი	entsprechend, angemessen, ordentlich
წესისაებრ-ი	ordentlich, anständig
შემოქმედებრ-ი	schöpferähnlich, schöpfergleich
მაშინდებრ-ი	damalig
ბარბაროზებრ-ი	nichtgriechisch
მშობლებრ-ი	heimatlich
ჰრომაელებრ-ი	lateinisch
ებრაელებრ-ი	jüdisch
თჳთმპყრობელებრ-ი	königlich
მეგჳპტელებრ-ი	ägyptisch
ადგილებრ-ი	örtlich
შვილებრ-ი	kindlich, kindesgleich
მოხუცებულებრ-ი	greisenhaft, weise
მოციქულებრ-ი	Apostel-, apostelgleich
ბერძულებრ-ი	griechenähnlich
წულებრ-ი	männlich, kindlich
ცეცხლებრ-ი	feuerähnlich
ჩემებრ-ი	meinesgleichen
ქერობინებრ-ი	den Cherubim angemessen
იონებრ-ი	griechisch
მთოვარებრ-ი	mondgleich
ბუგრებრ-ი	verdorben, verkommen; unrein
ბერებრ-ი	greis
დედაბერებრ-ი	altfrauenhaft
სულიერებრ-ი	seelisch
სოფლიერებრ-ი	weltlich
წესიერებრ-ი	ordentlich, anständig
მთავრებრ-ი	fürstlich
რიტორებრ-ი	rhetorisch
ზღაპრებრ-ი	märchenhaft
ყარყატებრ-ი	reiher-, storchenähnlich
მამაკაცებრ-ი	männlich, mannhaft
მჴეცებრ-ი	wild
საყუედრ-ი	Vorwurfs-, vorwurfsvoll
მრავალსალმობიერ-ი	sehr belästigend, sehr schmerzlich
კეთილლმობიერ-ი	mitfühlend
ულმობიერ-ი	gesund, unbekümmert, unbesorgt
მშობიერ-ი	gebärend
უშუმინვიერ-ი	seelenlos
ჭმუნვიერ-ი	traurig, betrübt
მღუნვიერ-ი	gurrend
წყლითმანკიერ-ი	wassersüchtig
თუალიერ-ი	sehend
ღმრთივსულიერ-ი	von Gott eingegeben, göttlich
რჩულიერ-ი	gesetzlich; gesetzmäßig, rechtmäßig; gesetzlich
ენაძლიერ-ი	schwerverständlich
წარმართთამიერ-ი	heidnisch
მკურნალთამიერ-ი	Arzt, ärztlich
ღჳნისსაფარდულთამიერ-ი	durch Weinhandel erworben
საჴმართამიერ-ი	eigennützig
ჰაერთამიერ-ი	klimabedingt
უმღჳძარესთამიერ-ი	für die äußerst Wachsamen / Vorsichtigen kennzeichnend
ქორწინებისამიერ-ი	ehelich
მცნებისამიერ-ი	dem Gebot entsprechend
უმეცრებისამიერ-ი	unwissenheitshalber
ქრთამისამიერ-ი	bestochen
ღჳნისამიერ-ი	vom Wein bedingt
ჭირისამიერ-ი	notbedingt
ხისამიერ-ი	vom Baum hervorgerufen, durch den Baum bedingt
კანონთმიერ-ი	kanonisch, offiziell anerkannt
ქრისტესმიერ-ი	von Christus kommend
მძლავრებისმიერ-ი	gewaltsam
მრავალსაქმიერ-ი	vielbeschäftigt
ქუეყანიერ-ი	irdisch
პირბედნიერ-ი	glücklich
სიტყუაშუენიერ-ი	redegewandt
ღმრთივშუენიერ-ი	von Gott verschönt
წუერშუენიერ-ი	schönbärtig
ფერშუენიერ-ი	schön, schönfarbig
ჴორცშუენიერ-ი	schön
სიტყუაპოვნიერ-ი	schlagfertig
ფასნიერ-ი	reich; reich
თანამეცნიერ-ი	wissend, kennend
სიტყუამეცნიერ-ი	klug redend
მრჩობლადმეცნიერ-ი	hochgelehrt
გულთმეცნიერ-ი	hellsehend, das Innere kennend
სიტყჳთმეცნიერ-ი	Redner, klug redend
წინაჲსწარმეცნიერ-ი	vorauserkennend
ჴელნაყოფიერ-ი	reiche Frucht / Ernte einbringend
ძაღუერ-ი	dumm, töricht
ოქროფერ-ი	goldfarben
მჴიისფერ-ი	grau
ნათლისფერ-ი	hell
მეწამულისფერ-ი	rot
ღჳძლისფერ-ი	violett
კაცისფერ-ი	menschenähnlich
ენდროჲსფერ-ი	rot
ოქროჲსფერ-ი	goldfarben
მდღევრ-ი	täglich
შოვრ-ი	fern
ჴორცთეთრ-ი	weiß
კაცისპირ-ი	menschenähnlich
ყშირ-ი	dick, dicht
ქორისქორ-ი	vielgeschossig
სწორ-სწორ-ი	gleichmäßig
ჰასაკითსწორ-ი	gleichaltrig
ჰასაკისსწორ-ი	gleichaltrig
სულსაძნაურ-ი	schwierig, schwer, schwer erträglich
ყრმებურ-ი	kindlich
მიზდურ-ი	eingestellt
ჰინდურ-ი	indisch
უძეურ-ი	kinderlos
სახეუკეთურ-ი	häßlich, böse
თანამოსუმურ-ი	gemeinsam trinkend
უშურ-ი	freigebig
კეთილადმსახურ-ი	tiefgläubig
მდღევართმსახურ-ი	für einen Tag / tagesweise eingestellt
ღმრთისმსახურ-ი	gläubig
ოც-ი ათას-ი	zwanzigtausend
ასი ათას-ი	hunderttausend
ხუთათას-ი	fünftausend
ოთხათას-ი	viertausend
ნასნას-ი	Affe (?)
სუბუქფას-ი	billig
უსაყოველთაეს-ი	äußerst allgemein
უზეჟთაეს-ი	höchster; höchster
უჟეჟთაეს-ი	höchster
უწყუდიადეს-ი	überaus dunkel
უმორწმუნეეს-ი	tiefgläubig
უთავეს-ი	hauptsächlich
უმკოდვეს-ი	äußerst arm
უფართეს-ი	überaus weit; bester
უნოტიეს-ი	überaus feucht, sehr wässerig
უდამაშურალეს-ი	noch ermüdender, überaus ermüdend
უმყრალეს-ი	überaus stinkend
უმარგებელეს-ი	äußerst nützlich
უმამხილებელეს-ი	überaus entlarvend / aufdeckend
უშეუძლებელეს-ი	völlig unmöglich
უგანმსუენებელეს-ი	noch mehr zu verwöhnen
უუვნებელეს-ი	überaus unbeschädigt
უშესაძრწუნებელეს-ი	überaus erschreckend
უმარცხჳნებელეს-ი	äußerst beschämend
უდაუჯერებელეს-ი	überaus glaubhaft
უშემოკრებელეს-ი	allseits erforscht
უსაშუებელეს-ი	äußerst leicht
უსაქებელეს-ი	äußerst lobenswert
უმალმობელეს-ი	äußerst schmerzhaft
უუგრძნობელეს-ი	äußerst gefühllos
უსაძაგელეს-ი	überaus verabscheuenswert
უსაწადელეს-ი	überaus wünschenswert
უგამოუცდელეს-ი	überaus erprobt, überaus erfahren
უმხედველეს-ი	äußerst gut zu sehend
უგამომწულილველეს-ი	eingehend ergründend
უუზრუნველეს-ი	überaus unbekümmert / sorglos; überaus unbekümmert / sorglos
უმკუეთელეს-ი	überaus scharf; überaus scharf
უმრთელეს-ი	äußerst gesund
უშორიელეს-ი	überaus fern
უპატივისსაცემელეს-ი	äußerst verehrenswert
უმიუწდომელეს-ი	überaus unerreichbar
უჴმელეს-ი	überaus trocken
უსაცინელეს-ი	überaus lächerlich
უშესაძინელეს-ი	bester
უზესკნელეს-ი	höchster
უქუესკნელეს-ი	am tiefsten / untersten befindlich
უნელეს-ი	äußerst schwach
უსაყუარელეს-ი	liebster, überaus geliebt
უგულისხმისმყოფელეს-ი	überaus verständig
უსულგრძელეს-ი	überaus gütig
უხელეს-ი	überaus verrückt
უსაკიცხელეს-ი	überaus schimpflich / tadelnswert; überaus schimpflich / tadelnswert
უწითლეს-ი	überaus rot
ულბილეს-ი	überaus weich / sanft
უცნობილეს-ი	äußerst klug
უგანგრძობილეს-ი	länger, längerdauernd
უადვილეს-ი	sehr leicht, leichter, leichtester; sehr leicht, leichter, leichtester
უცოდვილეს-ი	überaus sündig
უდაჴსნილეს-ი	äußerst hinfällig, äußerst zerrüttet
უგრილეს-ი	überaus kalt; überaus kalt
უწურილეს-ი	überaus klein; überaus klein
უსათნოყოფილეს-ი	bester
უმრავალნაწილეს-ი	äußerst verschiedenartig
უფრთხილეს-ი	überaus vorsichtig
უგანმზადებულეს-ი	besser vorbereitet
უგანცხადებულეს-ი	offenbarer, offenkundiger
უმოხუცებულეს-ი	überaus alt
უკეთილმითუალულეს-ი	für besser zu erachten
უგანკრძალულეს-ი	vorsichtiger, behutsamster
უდაფარულეს-ი	äußerst verborgen, versteckt
უუძრულეს-ი	überaus schwach; überaus schwach
უმსწრაფლეს-ი	äußerst schnell
უუფლეს-ი	hauptsächlichst; hauptsächlichst
უსხჳლეს-ი	äußerst dick
უმრწამეს-ი	kleinster, jüngster, gehorsam; kleinster, jüngster, gehorsam
უჰამეს-ი	überaus angenehm
უმწემეს-ი	kleinster, jüngster, gehorsam; kleinster, jüngster, gehorsam; kleinster, jüngster, gehorsam; kleinster, jüngster, gehorsam
უმწემეს-ი უმწემეს-ი	kleinster, jüngster, gehorsam
უმწემჱს-ი უმწემეს-ი	kleinster, jüngster, gehorsam
უმწამე-ჲ უმწემეს-ი	kleinster, jüngster, gehorsam
უყრმეს-ი	überaus klein
უსახარულევანეს-ი	äußerst froh / freudig
უმშუანეს-ი	mittlerer
უმრისხანეს-ი	äußerst zornig / wütend
უსახელოვნეს-ი	äußerst namhaft
უჴელოვნეს-ი	überaus geschickt / meisterhaft
უნიშნოვნეს-ი	äußerst bedeutsam
უდიდროვნეს-ი	äußerst groß
უჰაეროვნეს-ი	überaus glänzend, überaus ätherisch
უფეროვნეს-ი	überaus farbig
უმჴცოვნეს-ი	ältester
უახოვნეს-ი	tapferster
უგულმოდგინეს-ი	äußerst strebsam
ულიტონეს-ი	sehr einfach
უმრავალღონეს-ი	äußerst fleißig
უამაოეს-ი	völlig vergebens, völlig umsonst
უსამარადოეს-ი	ewig
უამავოეს-ი	völlig vergebens, völlig umsonst; völlig vergebens, völlig umsonst
უპატივოეს-ი	letzter, gewöhnlichster, schlechtester
უსაღმრთოეს-ი	überaus heilig
უსამღდელოეს-ი	überaus fromm, heilig
უუშჯულოეს-ი	überaus ungläubig
უკეთილსარწმუნოეს-ი	glaubhafter
უსარწმუნოეს-ი	äußerst glaubhaft
უურცხჳნოეს-ი	äußerst unverschämt; äußerst unverschämt
უუწესოეს-ი	überaus unanständig
უსამარადისოეს-ი	überaus ewig, ewigst
უსატკივარეს-ი	äußerst schmerzlich
უმძჳნვარეს-ი	äußerst böse
უკეთილსაჴმარეს-ი	besser gebräuchlich
უმოტყინარეს-ი	äußerst entzündet
უმცონარეს-ი	äußerst faul; äußerst faul
უკაცთმოყუარეს-ი	äußerst menschenfreundlich; äußerst menschenfreundlich
უღმრთისმოყუარეს-ი	überaus gottliebend
უმყარეს-ი	überaus fest
უცხარეს-ი	äußerst grausam
უმადლიერეს-ი	überaus dankbar
უსულიერეს-ი	seelisch
უდასაბამიერეს-ი	erster, anfänglichster
უზომიერეს-ი	äußerst maßvoll
უგულისჴმიერეს-ი	äußerst verständnisvoll
უქუეყანიერეს-ი	überaus bescheiden
უკადნიერეს-ი	sehr wagemutig
უპოვნიერეს-ი	äußerst reich
უღონიერეს-ი	überaus stark, überaus tüchtig
უმეცნიერეს-ი	überaus gelehrt / gebildet
უმიწნიერეს-ი	äußerst irdisch
უჯერეს-ი	untauglich, überaus schlecht
უმდოვრეს-ი	äußerst ruhig / friedlich
უსაჴმრეს-ი	äußerst notwendig; äußerst notwendig
უსაცნაურეს-ი	überaus verständlich
უმწითურეს-ი	überaus rot
უველურეს-ი	äußerst wild
უმოძღურეს-ი	überaus klug
უღმრთისმსახურეს-ი	überaus gottesfürchtig
უმქისეს-ი	überaus grausam / streng
უსწრაფიღირსეს-ი	hochersehnt
ურწმუნოებისღირსეს-ი	äußerst glaubwürdig
უსიტყჳსღირსეს-ი	überaus würdig
უთჳსეს-ი	nächster, äußerst nahestehend
უჭეშმარიტეს-ი	überaus wahr
უდრკუეს-ი	äußerst heimtückisch
ქუეს-ი	unterer
უცოფეს-ი	äußerst verrückt
უზრქეს-ი	überaus dick
ულაღეს-ი	überaus dreist / frech
უხენეშეს-ი	überaus böse, überaus schlecht
უმოშიშეს-ი	überaus furchtsam
უმოღუაწეს-ი	äußerst arbeitsam
უბილწეს-ი	unreinster, verdorbenster
ანგელოზთმსგავს-ი	engelhaft
თიკანთმსგავს-ი	zickleinartig
კამარისმსგავს-ი	bogenförmig
მკრდამდის-ი	bis zur Brust reichend
არავის-ი	niemandes, niemand gehörig
სამგზის-ი	dreimalig
საგონის-ი	zu bedenkend, anzunehmend
გუამისოვნებისშორის-ი	fleischlich
ერგასის-ი	fünfzig
ასერგასის-ი	einhundertfünfzig
ოთხასერგასის-ი	vierhundertfünfzig
მიმოს-ი	Mime, Nachahmungskünstler, nachahmend
ექუს-ექუს-ი	je sechs
ორმეოცდაექუს-ი	sechsundvierzig
უზეჟთაჱს-ი	höchster; höchster
უჟეჟთაჱს-ი	höchster; höchster
უზესთაჱს-ი	höchster
უზეშთაჱს-ი	höchster; höchster
უმჯობჱს-ი	bester, besserer
ჰუმჯობჱს-ი	bester, besserer; bester, besserer
უმშჳდჱს-ი	äußerst ruhig / friedlich
უსპეტაკჱს-ი	überaus weiß
უპაშტაკჱს-ი	äußerst günstig / bequem
უუბადრუკჱს-ი	überaus armselig
უმბრწყინვალჱს-ი	überaus glänzend
უბრწყინვალჱს-ი	glänzendster
უმალჱს-ი	äußerst schnell
უმდაბლჱს-ი	äußerst niedrig
უსარგებლჱს-ი	äußerst brauchbar / tauglich
უსაწყალობელჱს-ი	äußerst erbarmungswürdig
უმახლობელჱს-ი	äußerst nahestehend
უუზრუნველჱს-ი	überaus unbekümmert / sorglos
უმკუეთელჱს-ი	überaus scharf
უძნელჱს-ი	äußerst schwierig
უსანატრელჱს-ი	äußerst ersehnenswert
უსაკიცხელჱს-ი	überaus schimpflich / tadelnswert
უმრავლჱს-ი	überaus viel
უნათლჱს-ი	äußerst hell
უტკბილჱს-ი	überaus süß
ჰუადვილჱს-ი	leichterer, leichtester
უგრილჱს-ი	überaus kalt
უმოკლჱს-ი	überaus kurz
უშემკულჱს-ი	äußerst geschmückt
უუფლჱს-ი	hauptsächlichst
უახლჱს-ი	neuester, sehr nahestehend
უფიცხლჱს-ი	überaus grausam; überaus grausam
უმწემჱს-ი	kleinster, jüngster, gehorsam
უმრწემჱს-ი	kleinster, jüngster, gehorsam
უპატიოსნჱს-ი	äußerst verehrungswürdig
უბრძნჱს-ი	überaus weise
უურცხჳნოჱს-ი	äußerst unverschämt
უდარჱს-ი	schlechtester, geringster
უმცონარჱს-ი	äußerst faul
უმწარჱს-ი	äußerst bitter
უმდიდრჱს-ი	äußerst reich
უძლიერჱს-ი	überaus stark
უგონიერჱს-ი	äußerst klug
უმცირჱს-ი	äußerst winzig
უფატრჱს-ი	überaus faul / hohl
უუძლურჱს-ი	überaus schwach
უუგუნურჱს-ი	äußerst dumm
უძჳრჱს-ი	überaus böse
უმეტჱს-ი	äußerst viel
უბოროტჱს-ი	bösartiger, bösester
უქუჱს-ი	allerniedrigster, allerunterster, tiefster
უპირუტყუჱს-ი	äußerst tierisch
უმოსწრაფჱს-ი	äußerst schnell, bestrebter
უმტკიცჱს-ი	äußerst fest / aufrecht
უფიცხჱს-ი	überaus grausam
უწლოჲს-ი	überaus klein / wenig
უჴშოჲს-ი	überaus häufig
თანაშესატყჳს-ი	entsprechend
კაცისხატ-ი	menschenähnlich
მნაკეტ-ი	[Bedeutung unklar]
ათრვამეტ-ი	achtzehn
ოცდაათრვამეტ-ი	achtunddreißig
ორმეოცდათურამეტ-ი	achtundfünfzig
ცხრამეტ-ი	neunzehn; neunzehn
აცხრამეტ-ი	neunzehn
ოთხმეოცდააცხრამეტ-ი	neunundneunzig
ოთხმეოცდაცხრამეტ-ი	neunundneunzig
ოთხმეოცდაათცხრამეტ-ი	neunundneunzig
ათსამეტ-ი	dreizehn
ცამეტ-ი	dreizehn; dreizehn
ოცდაათცამეტ-ი	dreiunddreißig
ათშჳდმეტ-ი	siebzehn
ჩჳდმეტ-ი	siebzehn; siebzehn
აჩჳდმეტ-ი	siebzehn
ორმოცდათხუთმეტ-ი	fünfundfünfzig
ათსამმეტ-ი	dreizehn
თორმეტ-ი	zwölf; zwölf
ოცდაათორმეტ-ი	zweiunddreißig
სამეოცდაათორმეტ-ი	zweiundsiebzig
ორასსამეოცდაათექუსმეტ-ი	zweihundertsechsundsiebzig
ოცდათექუსმეტ-ი	sechsunddreißig
თოთხმეტ-ი	vierzehn; vierzehn
სახებოროტ-ი	böse
მყჳრტ-ი	dick, fest
სურსუტ-ი	unwürdig, unanständig
მარღუ-ი	zerstörend, verderbend
უსიტყუ-ი	stumm, unsäglich
ზარხუ-ი	[Bedeutung unklar]
უმარჯუ-ი	ungeschickt, unangemessen
შინამყოფ-ი	zu Hause befindlich
ქმრისქუეშემყოფ-ი	verheiratet
სიტყუალაღ-ი	dreist redend
ღმრთისმოშიშ-ი	gottesfürchtig
ნატაც-ი	geraubt, entführt
მიმრეც-ი	gebogen, gebeugt, geneigt
სამეოც-ი	sechzig; sechzig
ასსამეოც-ი	einhundertsechzig
სამმეოც-ი	sechzig
ორმეოც-ი	vierzig
შჳდასორმეოც-ი	siebenhundertvierzig
ოთხმეოც-ი	achtzig
ორმიოც-ი	vierzig; vierzig
სახეკეკლუც-ი	schön
წუერკეკლუც-ი	schönbärtig
პირკეკლუც-ი	schön
ჩრდილოჲთკერძ-ი	nach Norden gerichtet befindlich
თანაგანმზრახ-ი	beratend
ნიშდეხ-ი	niederer, elend
მკჳრცხ-ი	zu Fuß (gehend); rasch, schnell, tüchtig, lebendig, kräftig; rasch, schnell, tüchtig, lebendig, kräftig
სჯობ-ს	er übertrifft ihn, er ist besser
შეუგავ-ს	es ähnelt ihm
უძლავ-ს	er kann
უძნავ-ს	es fällt ihm schwer
ესავ-ს	er / sie hofft
წით-ს	es ist rot / gerötet
დამოსდი-ს	es rinnt / fließt / tropft herab
გარდამოსდი-ს	es läuft / fließt / rinnt ihm herab
უვი-ს	er hat
ზედაზი-ს	er sitzt darauf
აშუნ-ს	es steht / paßt ihm, es ist ihm angemessen
უძნ-ს	es fällt ihm schwer
მიმოდააქუ-ს	er trägt umher
ზეაქუ-ს	er hebt
შინაგანაქუ-ს	er trägt / bringt / schafft hinaus
ზემოაქუ-ს	er trägt herauf
წარაქუ-ს	er trägt / bringt / schafft fort
ჴელთდება-ჲ	Fangen, Geben, überreichen
დასარწმუნოვება-ჲ	überzeugen
შემსგავსებულება-ჲ	ähnlichkeit
გარდამატებულება-ჲ	überzogenheit
გამუჴლება-ჲ	in Abschnitte gliedern (Text)
ამპარტავანება-ჲ	Hochmut, Stolz, überheblichkeit
ანპარტავანება-ჲ	Hochmut, Stolz, überheblichkeit; Hochmut, Stolz, überheblichkeit
ძჳრჴსენება-ჲ	Nachtragen, Unfähigkeit zu verzeihen
აჩრდილოვნება-ჲ	Schattenhaftigkeit, ähnlichkeit
ჯობინება-ჲ	übertreffen; übertreffen
ფანდურება-ჲ	auf der Leier spielen
უმეტესება-ჲ	Mehrheit, überlegenheit
უმეტჱსება-ჲ	Mehrheit, überlegenheit; Mehrheit, überlegenheit
თანანაშობობა-ჲ	ähnlichgebären
საზოგადობა-ჲ	Allgemeinheit, öffentlichkeit; Allgemeinheit, öffentlichkeit
მრავლადმცენარეობა-ჲ	überfluß
მრავალმცენარეობა-ჲ	Fülle, überfluß
გამომავალობა-ჲ	die Fähigkeit herauszukommen; die Fähigkeit herauszukommen
მოუკლებელობა-ჲ	Fülle, überfluß
უჴმარსაგონებელობა-ჲ	Betrachtung als unbrauchbar
უძლურსაგონებელობა-ჲ	Betrachtung als kraftlos
მარწმუნებელობა-ჲ	überzeugen
თანამზრუნველობა-ჲ	sorgen, helfen
მიმრთუმელობა-ჲ	überreichen
წარმვლენელობა-ჲ	Wegschicken, übergeben
დაშთომილობა-ჲ	übrigbleiben
მითუალულობა-ჲ	Erhalten, Annehmen, übergeben
ამპარტავანობა-ჲ	Hochmut, Stolz, überheblichkeit; Hochmut, Stolz, überheblichkeit
საზოგადოობა-ჲ	Allgemeinheit, öffentlichkeit
საწყინოობა-ჲ	überdrüssigsein, überdrüssigwerden
წინასწრობა-ჲ	Zuvorkommen, überholen
მოსწრობა-ჲ	überholen
წინამოსწრობა-ჲ	überholen
წინაწარსწრობა-ჲ	überholen
უმჯობჱსობა-ჲ	übertreffen
უპირადჱსობა-ჲ	Führerschaft, überlegenheit
უმეტჱსობა-ჲ	Mehrheit, überlegenheit
თანაგანმზრახობა-ჲ	Verhandlung, übereinkommen
წინამოსრბა-ჲ	überholen
ქუეყანისზედა-ჲ	irdisch, auf der Erde lebend
მცირედა-ჲ	sehr klein
მანდა-ჲ	dortig
მცირეა-ჲ	sehr klein; sehr klein
ესეა-ჲ	er / sie / es
მოსხლვა-ჲ	Beschneiden (der äste)
კუმინვა-ჲ	Stöhnen, ächzen
მულკუვა-ჲ	Knospe (?)
ჟეჟთა-ჲ	höchster
ზუგია-ჲ	Ahorn (?)
ჰოია-ჲ	Großer Wagen / Bär (Sternbild)
მოკლეკა-ჲ	sehr kurz
ცონცორიკა-ჲ	umherstreifend
რომელა-ჲ	der, welcher
დაჩხრეკილა-ჲ	geschrieben
სხუაჴმა-ჲ	in anderer Mundart sprechend
უცხოჴმა-ჲ	fremdsprachig
ჩემთანა-ჲ	bei mir befindlich
სხუაენა-ჲ	fremdsprachig
უცხოენა-ჲ	fremdsprachig
მასშინა-ჲ	damalig
ამისშინა-ჲ	darin befindlich
ქუეყანისშინა-ჲ	irdisch, diesseitig
ქალაქისშინა-ჲ	in der Stadt befindlich
მატლთსაჭმელ-ქმნა-ჲ	Wurmfutter werden
ჩასდუდარა-ჲ	Kuppel (?)
არღარა-ჲ	nichts mehr
ერჳთრა-ჲ	rot
მცირა-ჲ	sehr gering
დიდისსასყიდლისა-ჲ	teuer, kostbar
შჳდწლისა-ჲ	siebenjährig
სამთჳსა-ჲ	drei Monate alt
თავ-ცოტა-ჲ	kleinköpfig
თუალცოტა-ჲ	kleinäugig
ცოცოტა-ჲ	ein ganz klein wenig
მემცნებე-ჲ	vertrauenswürdig
მოტკბე-ჲ	süßlich
მჯობე-ჲ	besser, übertreffend; besser, übertreffend
ღრმაბაგე-ჲ	stotternd
მელაზმაგე-ჲ	mit Gold oder Silber beschlagen
მემაეგე-ჲ	machend, tuend
უწმიდე-ჲ	überaus rein
მორიდე-ჲ	zurückhaltend, schüchtern, ausweichend; zurückhaltend, schüchtern, ausweichend
მიმლოდე-ჲ	wartend
მომლოდე-ჲ	wartend
შჳძღუდე-ჲ	siebenfach ummauert
მომჟავე-ჲ	säuerlich
მფუვე-ჲ	aufgehend
მეოცდაათე-ჲ	dreißigster
ოთხმეათე-ჲ	vierzehnter
სატჳრთე-ჲ	aufzuladend, Last auf sich zu nehmend
მდუმრიე-ჲ	leise
წყლითმაკე-ჲ	wassersüchtig
მბრწყინვალე-ჲ	glänzend, glanzvoll
მობრწყინვალე-ჲ	schwach / matt glänzend
მბრდღჳნვალე-ჲ	angezündet
მგორვალე-ჲ	rollend; rollend
მცურვალე-ჲ	schwimmend; schwimmend
მწყრომალე-ჲ	wütend, zornig; wütend, zornig
მძრომალე-ჲ	kriechend
დიდადმოწყალე-ჲ	sehr barmherzig, sehr wohltätig
მოლოზანთმოწყალე-ჲ	den Nonnen barmherzig gesonnen
მოსასყიდლე-ჲ	eingestellt, gedungen
უმახლობელე-ჲ	äußerst nahestehend; äußerst nahestehend
უძუელე-ჲ	überaus alt, ältester
ახალმონათლე-ჲ	frisch getauft
მოწითლე-ჲ	rötlich
მეორწილე-ჲ	verdoppelnd
თითმოკლე-ჲ	kurzfingerig
ტანმოკლე-ჲ	kleinwüchsig
მოცრემლე-ჲ	tränenüberströmt, tränend
უდაკლებულე-ჲ	äußerst gering
თანამესართულე-ჲ	im gemeinsamen Haus wohnend
თანამოსართულე-ჲ	unter einem Dach wohnend
უსრულე-ჲ	unvollständig, unvollkommen
კადნიერებისმოძულე-ჲ	dreistigkeitshassend
ღმრთისმოძულე-ჲ	gotthassend
თანამეღჳძლე-ჲ	nahe verwandt
მომჭლე-ჲ	mager
უმწამე-ჲ	kleinster, jüngster, gehorsam; kleinster, jüngster, gehorsam; kleinster, jüngster, gehorsam; kleinster, jüngster, gehorsam; kleinster, jüngster, gehorsam; kleinster, jüngster, gehorsam; kleinster, jüngster, gehorsam
უმრწემე-ჲ	kleinster, jüngster, gehorsam; kleinster, jüngster, gehorsam; kleinster, jüngster, gehorsam; kleinster, jüngster, gehorsam; kleinster, jüngster, gehorsam; kleinster, jüngster, gehorsam; kleinster, jüngster, gehorsam
მობერმე-ჲ	rot
მომრუმე-ჲ	dunkel, schwärzlich
მფრთოვანე-ჲ	fliegend
მოზღვანე-ჲ	Nachbar, angrenzend
მთხოანე-ჲ	bittend, vermittelnd
მფუანე-ჲ	aufgehend
მომწუანე-ჲ	grünlich
მსუქანე-ჲ	dick, fett; dick, fett
მეუბნე-ჲ	auf dem Platz befindlich
მერაოდენე-ჲ	wievielter; wievielter
მოჴსენე-ჲ	sich erinnernd, gedenkend
ძჳრმოჴსენე-ჲ	nachtragend
ძჳრისმოჴსენე-ჲ	nachtragend
უგულმოდგინე-ჲ	wünschenswerter
მიმომრონინე-ჲ	hin- und hergehend
მომღონე-ჲ	bewerkstelligend, zuwegebringend
მკჳრნე-ჲ	verwundert
უპატიოსნე-ჲ	äußerst verehrungswürdig; äußerst verehrungswürdig
სასირცხჳნე-ჲ	schändlich, schandbar
მეამაოე-ჲ	Nichtigkeiten verrichtend, vergebens machend
ზედამდებარე-ჲ	oben befindlich, obig, oberer
მგოდებარე-ჲ	trauernd, klagend
მტყებარე-ჲ	weinend
შემოგარე-ჲ	ringsum befindlich
სჯულისგარე-ჲ	ungesetzlich, gesetzwidrig
მრავალმღელვარე-ჲ	jähzornig
მკლთოლვარე-ჲ	glänzend
გამომკლთოლვარე-ჲ	herausscheinend, hervorscheinend; herausscheinend, hervorscheinend
მწთოლვარე-ჲ	tropfend
სისხლმწთოლვარე-ჲ	bluttropfend
დამომწთოლვარე-ჲ	herabtropfend
მტოლვარე-ჲ	fliehend, flüchtig
მღუნვარე-ჲ	gebogen, gebeugt; gebogen, gebeugt
მლოცვარე-ჲ	geflohen, flehend
ქუემდებიარე-ჲ	gelähmt
მტფობიარე-ჲ	sich wärmend
პირველმშობიარე-ჲ	erstmals gebärend
თანამდგომარე-ჲ	nahestehend
ზედამჯდომარე-ჲ	oben sitzend
ქუემჯდომარე-ჲ	unten sitzend, still, ruhig
თჳთმცენარე-ჲ	selbstgewachsen
თესლმცენარე-ჲ	an Gonorrhoe erkrankt
შინაგანმცენარე-ჲ	innen wachsend
წუთხმცენარე-ჲ	eitrig
ქუეგამდინარე-ჲ	auslaufend, leck
თესლმდინარე-ჲ	an Gonorrhoe erkrankt
სისხლმდინარე-ჲ	sehr starke Blutung / Menstruation habend
სისხლგარდმომდინარე-ჲ	Blut vergießend, verwundet
კეთილადაღმომდინარე-ჲ	gut / reichlich herauskommend
თჳთაღმომდინარე-ჲ	selbstherausfließend
სიტყუათმოყუარე-ჲ	viel redend, gern redend
მცენარეთმოყუარე-ჲ	dicht bewaldet
შვილთმოყუარე-ჲ	kinderliebend
სულთმოყუარე-ჲ	menschenfreundlich
უცხოთმოყუარე-ჲ	gastfreundlich
ქმართმოყუარე-ჲ	den Ehemann liebend
ჴორცთმოყუარე-ჲ	leibliebend, dem Leib huldigend
ნიჭთმოყუარე-ჲ	freigebig
ქრისტესმოყუარე-ჲ	christusliebend
ძაგებისმოყუარე-ჲ	hassend, verabscheuend, schmähend
დიდებისმოყუარე-ჲ	ruhmsüchtig
სათნოებისმოყუარე-ჲ	Gutes tuend
ცხორებისმოყუარე-ჲ	lebensliebend
უკეთურებისმოყუარე-ჲ	übeltäter
მამლობისმოყუარე-ჲ	die Paarung liebend
ღირსობისმოყუარე-ჲ	hochmütig
ხუასტაგისმოყუარე-ჲ	habgierig
თავისმოყუარე-ჲ	ehrliebend, ehrgeizig
ძლევისმოყუარე-ჲ	siegesgewohnt, stolz
ღმრთისმოყუარე-ჲ	gottesliebend, fromm
სწავლისმოყუარე-ჲ	lernfreudig, wissensdurstig
შვილისმოყუარე-ჲ	kinderliebend, kinderlieb
მამლისმოყუარე-ჲ	das männliche Geschlecht liebend
შჯულისმოყუარე-ჲ	gesetzeinhaltend
უფლისმოყუარე-ჲ	gottesliebend, fromm, herrenliebend
ჴდომისმოყუარე-ჲ	Streithals, streitsüchtig
ძმისმოყუარე-ჲ	bruderliebend
სტუმრისმოყუარე-ჲ	gastfreundlich
ქმრისმოყუარე-ჲ	den Ehemann liebend
თანამწუხარე-ჲ	betrübt, gemeinsam trauernd
თანამოზღვრე-ჲ	angrenzend
მოთეთრე-ჲ	weißlich
ნაყრმცირე-ჲ	wenig essend
უმცირე-ჲ	äußerst winzig; äußerst winzig
უაზნაურე-ჲ	anständiger, rechtschaffenster
მოწითურე-ჲ	rötlich
თანამოვაჭრე-ჲ	gemeinsam Handel treibend
მესამჴრე-ჲ	reich
მკჳრსე-ჲ	verwundert, erstaunt
მწჳსე-ჲ	erwachsen, groß
ოცდამეთერთმეტე-ჲ	einunddreißigster
უმეტე-ჲ	äußerst viel; äußerst viel
მომმუხუე-ჲ	verbrennend, reißen / platzen / springen lassend
უმოსწრაფე-ჲ	äußerst schnell, bestrebter; äußerst schnell, bestrebter
მწუჱფე-ჲ	fest, dicht (Haar)
აღმღე-ჲ	nehmend, emporhebend, ergreifend
ნავისგარეშე-ჲ	außerhalb des Schiffes befindlich
უღლისქუეშე-ჲ	unterdrückt, unterjocht
საფუძველმტკიცე-ჲ	fest, hart, gut fundiert
უმტკიცე-ჲ	äußerst fest / aufrecht; äußerst fest / aufrecht
მჴრცე-ჲ	grauhaarig; grauhaarig
მრავალბჭე-ჲ	vieltürig
პირუტყუთასახე-ჲ	tierhaft
სხუასახე-ჲ	andersartig
ჰავსახე-ჲ	böse, bösartig
ესევითარისახე-ჲ	solcherart
ხერხისახე-ჲ	sägeartig
შენსახე-ჲ	deinesgleichen
ორსახე-ჲ	zweierlei
იკანკლედობისსახე-ჲ	ähnlich wie gewunden / krumm
ნიგუზისსახე-ჲ	nußähnlich
ნათლისსახე-ჲ	hell
ცეცხლისსახე-ჲ	feuerähnlich, feuergleich
ფეშხუენისსახე-ჲ	tellerförmig
ქოთნისსახე-ჲ	topfähnlich
ისრისსახე-ჲ	pfeilförmig
მჴეცისსახე-ჲ	einem wilden Tier ähnlich
სახისსახე-ჲ	entfernte ähnlichkeit
შემხე-ჲ	berührend
სატუხე-ჲ	verabscheuenswert, abscheulich, dümmlich
მკჳრცხე-ჲ	rasch, schnell, tüchtig, lebendig, kräftig
სათიჴე-ჲ	zur Tonbereitung geeignet / dienend
უმონაგებო-ჲ	arm, besitzlos
უვითარებო-ჲ	unvergleichlich
უნაშობო-ჲ	kinderlos
უარზანიგო-ჲ	unwürdig
უზოგადო-ჲ	unvermischt
უცხადო-ჲ	verborgen
სასიწმიდო-ჲ	heilig
ჰინდო-ჲ	Inder, äthiopier
ამავო-ჲ	unnütz, leer, vergeblich, nichtig; unnütz, leer, vergeblich, nichtig
უზღვევო-ჲ	kostenlos
საღელვო-ჲ	aufregend
უღელვო-ჲ	ruhig, friedlich
უმზო-ჲ	unvorbereitet
საბარბაროზო-ჲ	nichtgriechisch
სამათო-ჲ	ihr, deren; persönlich
უზეთო-ჲ	ohne öl
უსიკეთო-ჲ	böse
უღმთო-ჲ	ungläubig, gottlos; ungläubig, gottlos
თუალფართო-ჲ	großäugig
პირფართო-ჲ	breitgesichtig
სამღრთო-ჲ	Gottes-, göttlich
გრძელსაწუთო-ჲ	langandauernd, langlebig
საიშჳთო-ჲ	selten
უსძალო-ჲ	unverheiratet
სამწვალებლო-ჲ	häretisch
უმრავალსასყიდლო-ჲ	billig
უსარგებელო-ჲ	unbrauchbar, untauglich
უგანსაცდელო-ჲ	gefahrlos
უსაფარველო-ჲ	unbekleidet
უმცველო-ჲ	ungeschützt
ურომელო-ჲ	unbestimmbar, undefinierbar
საგრძელო-ჲ	lang, langandauernd
უმრავლო-ჲ	nicht zahlreich
უმღილო-ჲ	ohne Maden, unverderblich
უსამოსლო-ჲ	ohne Kleidung, nackt
საგანშორებულო-ჲ	asketisch
უსარტყლო-ჲ	abgesetzt, entlassen
ურაბამო-ჲ	unzählig
ცითგამო-ჲ	himmlisch
უგუამო-ჲ	immateriell
უსქემო-ჲ	weltlich
უნუგეშინისცემო-ჲ	trostlos, verzweifelt
საქრისტეანო-ჲ	christlich
ურავდენო-ჲ	unzählig
უმოჴსენო-ჲ	vergessend
უამპარტავნო-ჲ	bescheiden
უთნო-ჲ	unrein, abscheulich
ულხინო-ჲ	nicht zu beruhigend, nicht zu besänftigend
სამდაბიონო-ჲ	einfach, niederer
უცონო-ჲ	fleißig; fleißig
სამუნო-ჲ	dortig, jenseitig
უოცნო-ჲ	unvorstellbar
სასიბრძნო-ჲ	weise
სასირცხჳნო-ჲ	schändlich, schandbar; schändlich, schandbar
უვითარო-ჲ	unvergleichlich
უკადრო-ჲ	nicht wagend, schüchtern
უკადნიერო-ჲ	nicht wagend, schüchtern, bescheiden
უმთავრო-ჲ	führerlos
საწინავრო-ჲ	zukünftig, künftig
უმჯავრო-ჲ	ungerecht; ungerecht
უმშჯავრო-ჲ	ungerecht; ungerecht
უნაწევრო-ჲ	ganz, ungeteilt
სასწორო-ჲ	gleichmäßig
მომწითურო-ჲ	rötlich; rötlich
უაღჳრო-ჲ	zügellos
მჭლე-ასო-ჲ	mager
ულოღარიასო-ჲ	ohne Rechenschaft abzulegen
თანასამარადისო-ჲ	immer zusammen seiend
სადიდისო-ჲ	zu preisend, zu verherrlichend
უსჳნიდისო-ჲ	gewissenlos
უჴამსო-ჲ	unangemessen
საურთიერთარსო-ჲ	gegenseitig, gemeinsam
საერკოლოტო-ჲ	zum Nachfolger / Prinzen gehörig
სალერკოლოტო-ჲ	zum Nachfolger / Prinzen gehörig; zum Nachfolger / Prinzen gehörig
უმეუფო-ჲ	ohne König, frei
უქალაქო-ჲ	ohne Stadt, heimatlos
უქეცო-ჲ	schuppenlos
უსიმტკიცო-ჲ	nicht fest; verboten
უმტკიცო-ჲ	schwankend, unbeständig, unwahr
უანდერძო-ჲ	ohne ein Testament hinterlassen zu haben
ზედაკერძო-ჲ	oben befindlich, obig, oberer
უკუანაკერძო-ჲ	auf der Rückseite befindlich
თავითკერძო-ჲ	an der Vorderseite befindlich
მრავლითკერძო-ჲ	allseitig, vielseitig
მარჯუენითკერძო-ჲ	rechts befindlich, richtig
მარცხენითკერძო-ჲ	links befindlich
სამხრითკერძო-ჲ	Süd-, südlich, nach Süden gewandt
ქუეჲთკერძო-ჲ	unten befindlich
ზემოკერძო-ჲ	oben befindlich
ქუემოკერძო-ჲ	untere Seite, unten befindlich
წიაღკერძო-ჲ	jenseitig, drübig
უბერწო-ჲ	fruchtbar, kinderhabend
მარჯო-ჲ	geeignet
