მეერთისა	Pantokrator
გძღაბ-ი	Igel; Igel
სინჯაბ-ი	Eichhörnchen
მონაგდებ-ი	frühgeboren, Frühgeburt
ნაცოდვებ-ი	Sünde
მწინაჲსწარმეტყუელებ-ი	Prophet
თავობისმნებ-ი	herrschsüchtig, Karrierist
გარემძებ-ი	Vertriebener, Flüchtling
ნავასხებ-ი	geliehen, entliehen, Kredit
მგუერდობ-ი	Anverwandter
მღამეობ-ი	Fledermaus; Fledermaus
მპირველობ-ი	Gehilfe des Steuermanns
მსნეულობ-ი	Kranker
მჴედართმფლობ-ი	Heerführer, Feldherr
მსამობ-ი	an dritter Stelle rangierender Truppendienstgrad
მღამობ-ი	Fledermaus; Fledermaus
მმისნობ-ი	falscher Prophet
კჳნობ-ი	Mönchszelle, Gemeinschaftsraum
მღამოობ-ი	Fledermaus
მმიმოობ-ი	Gaukler
პირველმთავრობ-ი	oberster Verwalter
მმთავრობ-ი	Führer, Anführer
განმმსტრობ-ი	Späher, Spion
ჴელისსაპყრობ-ი	in der Hand zu haltend; Schwert
საჭეთმპყრობ-ი	Steuermann
მთჳსობ-ი	Nächster, Verwandter
მმეფობ-ი	König
წინაგანმწყობ-ი	Widersacher, Gegner
ნაშობისნაშობ-ი	Nachkomme
წუმწუბ-ი	Schwefel
წუნწუბ-ი	Schwefel; Schwefel
ჰროარდაგ-ი	Sendschreiben, Befehl
ნოაგ-ი	Stimme, Klang, Melodie, Gesang; Stimme, Klang, Melodie, Gesang
შივშაგ-ი	Duftstoffgefäß, Duftfläschchen
თუედადეგ-ი	Monatsanfang
ზოგისზოგ-ი	Hälfte
ჴმეად-ი	ungesäuertes Brot
ჴელისჴელად-ი	Lohn, Vergütung; gewöhnlich
სახლად-ი	Haus, Familie*sh 
ტომად-ი	Landsmann
ბურქუად-ბურქუად-ი	Rauchschwaden
ქაღად-ი	Papier
პილოჲსძუალედ-ი	aus Elfenbein
ოთხკედლედ-ი	Vierseiter
ნოაგთმოქმედ-ი	Koch
ჴელითმოქმედ-ი	Arbeiter, Handwerker
ჴელოვნებისმოქმედ-ი	Handwerker
გრძნებისმოქმედ-ი	Hexe, Zauberer
ნავისმოქმედ-ი	Schiffbauer
ნელსაცხებლისმოქმედ-ი	Spezereienzubereiter
წინააღდგომისმოქმედ-ი	Gegner, Widersacher
ქუეყანისმოქმედ-ი	Bodenbearbeiter, Bauer
პურისმოქმედ-ი	Bäcker
პილენძისმოქმედ-ი	Kupferschmied
თიჴისმოქმედ-ი	Töpfer
ჯაჭჳსმოქმედ-ი	Waffenhersteller
ჴბოვრედ-ი	Kalbs-, mit einem Kalb
სამქორედ-ი	drittes Stockwerk
ოქროაღჳრედ-ი	mit goldenem Zaumzeug
მკედისნაწყუედ-ი	Fadenstück
სამშუედ-ი	Busch einer Pflanze mit drei zusammenstehenden Dornen, Tribolos
რიცხუედ-ი	Gezähltes, rhythmische Sprache
ქედ-ქედ-ი	großer Berg
ოქრობეჭედ-ი	goldener Ring
ადგიდ-ადგიდ-ი	Stellen, Orte
მუცელდიდ-ი	Großbäuchiger
კეთილდიდ-ი	reich, voller Güte
სხეულდიდ-ი	von großem Körperbau
სკალიდ-ი	Spaten
ყრმიდ-ი	junge Frau
ქლანიდ-ი	Chlamys; Chlamys
სფჳრიდ-ი	Korb
სამარიტიდ-ი	Samariterin
ავანდ-ი	Gesetz, Tradition
მეჰევანდ-ი	Halskette, Kette; Ring
ერებინდ-ი	Erbse
თანაგუნდ-ი	Gruppenkamerad
ხლამჳნდ-ი	Chlamys
მგუერდ-ი	Seite, Hang; Maß; Rippe
მგრძნებავ-ი	Zauberer
პორფირისმღებავ-ი	Rotfärber
ანბავ-ი	Geschichte, Sache, Angelegenheit, Nachricht, Gerücht; Geschichte, Sache, Angelegenheit, Nachricht, Gerücht; Geschichte, Sache, Angelegenheit, Nachricht, Gerücht
ჰანბავ-ი	Geschichte, Sache, Angelegenheit, Nachricht, Gerücht; Geschichte, Sache, Angelegenheit, Nachricht, Gerücht
ურთავ-ი	Torflügel
ერისთავთ-ერისთავ-ი	Oberster Heerführer (georg. Titel)
დასისთავ-ი	Militärführer, Chorleiter
სუეტისთავ-ი	Kapitell
წყაროჲსთავ-ი	Quelle
კუროჲსთავ-ი	Dornstrauch
თთჳსთავ-ი	Monatsbeginn
კუროჲთავ-ი	Dornstrauch; Dornstrauch
მზუელავ-ი	Schauspieler, Nachahmer
ნაღელავ-ი	Welle, Woge
თუალთსაოლავ-ი	Augentusche
ვასკულავ-ი	Stern; Stern
მოჭრტინავ-ი	Kläger
მიმომწლონავ-ი	Ausführender eines Gerichtsurteils; umherlungernd
მოდრტჳნავ-ი	Kläger
ზოპავ-ი	Ysop; Weihwedel
მზოპავ-ი	Lügner, Prahler
თუალჟივჟავ-ი	mit scheckigen Augen
მჰაზრავ-ი	Wahrsager
მრგულიადშესაწირავ-ი	Opfer
ფასისშესაწირავ-ი	Geldopfer
თავუბურავ-ი	mit unverhülltem Kopf
უცხონათესავ-ი	Ausländer, Fremdstämmiger
ნალესავ-ი	Rückstand vom Schleifen
წიგნისტყავ-ი	Pergament
თხისტყავ-ი	Jacke aus Ziegenfell
ხილისსაცავ-ი	Zelt / Hütte der Obsthüter
ფასისსაცავ-ი	Vorratslager
ულოცავ-ი	ohne Gebet
შემომზრახავ-ი	Besprecher
ქალდევ-ი	Chaldäer, chaldäischer Priester
ნაცოდევ-ი	Sünde
მკურისკევ-ი	Harz
ნაკაცევ-ი	ehemaliger Mensch
წურილმოქცევ-ი	Komma, Beistrich
შჳდეულისმოქცევ-ი	Woche
მჴევ-ი	Schlucht, Tal; Schlucht, Tal
მკლველებრივ-ი	Mörder-
მონებრივ-ი	Sklaven-, Diener-
ჰაერებრივ-ი	luftig, Luft-
პირუტყუებრივ-ი	tierisch, wie Nichtsprechende; tierisch, wie Nichtsprechende
მეუფებრივ-ი	Reich, Königreich
ერისკაცობრივ-ი	bürgerlich, Bürger-
სწორპატივ-ი	gleiche Verehrung, gleiche Würde
კუვ-ი	Schildkröte; Schildkröte
ზეეზ-ი	kostbarer Stoff, Byssos
სპანქრეზ-ი	Brötchen
ქარტეზ-ი	Pergament
მჴეცთევზ-ი	Raubfisch, Fischbestie
ფარაოზ-ი	Leuchtturm
სინგელოზ-ი	Synkellos, Helfer oder Stellvertreter eines kirchlichen Würdenträgers
ფანოზ-ი	große Leuchte; große Leuchte
სჳნდიკნოზ-ი	Mutter des getauften Kindes
კჳპაროზ-ი	Zypresse; Zypresse
სინკლიტოზ-ი	Senat(smitglied)
ანდერზ-ი	Vermächtnis; Vorwort, Nachwort, Zusatz; Vermächtnis; Vorwort, Nachwort, Zusatz
ნათ-ი	Licht
სასარკინოზეთ-ი	Arabien
მაკედონიეთ-ი	Makedonier
აღმოსავალეთ-ი	Osten
სიკარეთ-ი	Räuber
ზოგებით-ი	teilweise, Teil-
თუალმორიდებით-ი	mit schlechtem Augenlicht
ქალწულებით-ი	ohne Gatten
თესლოვანებით-ი	Samen-
თესლოვნებით-ი	Samen-; Samen-
მონაზონებით-ი	Mönch-, Nonnen-
მეუდაბნოებით-ი	Eremiten-
ძმათმოყუარებით-ი	Bruderliebes-
მოღუაწებით-ი	Fürsorge-, Betreuungs-
შობისდღითობით-ი	Geburtstags-
მკურნალობით-ი	Arzt-, ärztlich, Heil-
მღერალობით-ი	zur Unterhaltung
თჳთმხილველობით-ი	Augenzeugen-
სადღესასწაულობით-ი	Feiertags-
მოსაჯულობით-ი	Anklage-
სამღდელოობით-ი	Priester-
სასძლოობით-ი	Lobpreisung der Muttergottes
მღდელთმთავრობით-ი	Bischofs-
თანამოსუმურობით-ი	Zech-
მწყემსობით-ი	Hirten-
თანაგანმზრახობით-ი	ratgeberisch, Verhandlungs-
დასავალით-ი	Westen
აღმოსავლით-ი	Osten; Osten
სასთუნლით-ი	Kopfseite
სიყუარულით-ი	Liebes-
ცოდვისაძლით-ი	Opfer zur Vergebung der Sünden
ჯმნით-ი	Abschiedsgruß
სომხით-ი	Armenien; Armenien
ფსანთ-ი	Bastmatte; Bastmatte
აფსინთ-ი	Wermut; Wermut
ელამოთ-ი	Vorraum (der Kirche)
სახარებისამიმართ-ი	Evangelien-
მომართ-ი	Frage
ევფუთ-ი	Priestergewand; Priestergewand
სიტყჳთ-ი	mit Worten, in Worten
ტრედაკ-ი	Täubchen
ჰროარდაკ-ი	Sendschreiben, Befehl; Sendschreiben, Befehl
გოზაკ-ი	Becher; Becher
ნიგუზაკ-ი	nußförmig(e Schale); nußförmig(e Schale)
ხარტოფილაკ-ი	Bibliothekar; Bibliothekar
დისწულაკ-ი	kleiner Neffe, kleine Nichte
ძმისწულაკ-ი	kleiner Neffe, kleine Nichte
ყრმაკ-ი	Kleinkind, Kindchen
ჰეშმაკ-ი	Teufel, Satan, böser Geist, Dämon; Teufel, Satan, böser Geist, Dämon
პალატ-ბანაკ-ი	Königshof
წუენაკ-ი	Süppchen
ტომარაკ-ი	Handschriftenkodex; Beutel, Sack
ჰურაკპარაკ-ი	Platz, Straße
სტავრაკ-ი	ein kostbarer Stoff, Brokat
სტჳრაკ-ი	Gummi(baum)
ჰროვარტაკ-ი	Sendschreiben, Befehl; Sendschreiben, Befehl
ჰროარტაკ-ი	Sendschreiben, Befehl; Sendschreiben, Befehl
შოშაკ-ი	Trense
თანამუშაკ-ი	Mitarbeiter
კუარცხბეკ-ი	Podest, Schemel; Podest, Schemel
სპონდიკ-ი	leichter Baustein
უჟიკ-ი	Meder
არქიმანდრიკ-ი	Klostervorsteher, Abt, Archimandrit; Klostervorsteher, Abt, Archimandrit
პავასიკ-ი	Beutel, Tasche
პაჲვასიკ-ი	Beutel, Tasche
მუსიკ-ი	Musiker
დალმატიკ-ი	ärmelloser Chiton
ლეკტიკ-ი	Sänfte, Trage
უფფიკ-ი	Dienst, Aufgabe, Offizium
საბერკ-ი	Strauch, Hecke
კუარცხბერკ-ი	Podest, Schemel; Podest, Schemel
ჭაპუკ-ი	Jugendliche(r), Jüngling; Jugendliche(r), Jüngling
ზედამიმავალ-ი	Angreifer
შინაგანმავალ-ი	Nahestehender, Getreuer
ქუეშეწარმავალ-ი	unten kriechend, Kriechtier
თანწარმავალ-ი	Reisender
მზისდასავალ-ი	Sonnenuntergang, Westen
წინაშესავალ-ი	Vorwort
წიაღმოსავალ-ი	Ausgang aus dem Wasser
მზისაღმოსავალ-ი	Sonnenaufgang, Osten
მურკნვალ-ი	Wäscher, Reiniger, Walker; Wäscher, Reiniger, Walker
დღესაშოვალ-ი	Mittag; Mittag
ჴამლისმკერვალ-ი	Schuhmacher
საჭითმხერვალ-ი	Steuermann
თანამცორვალ-ი	Leibwächter
წინამცორვალ-ი	Bote
თანაწარმცორვალ-ი	Leibwächter
თანამცურვალ-ი	Mitreisender zu Schiff
დღესაშუვალ-ი	Mittag
მთავარმზრახვალ-ი	Oberratgeber
უნჯაკალ-ი	Verwalter, Kellermeister
ოთხეკალ-ი	Dornenstrauchart
მოსაჴსენებელთმწერალ-ი	Testamentsschreiber
სიმიაჲთმწერალ-ი	Chronist
შჯულისმწერალ-ი	Gesetzeskundiger, Gesetzesschreiber
წიგნისმწერალ-ი	Schreiber
ანდერძისმწერალ-ი	Abschreiber
საგუსალ-ი	Gewebe, Faden
მზისთუალ-ი	Sonne
ურმისთუალ-ი	Rad
ნარისუალ-ი	Schurwolle
ჴორც-ძუალ-ი	Fleisch und Knochen
ზურგისძუალ-ი	Rückgrat, Wirbelsäule
პილოჲსძუალ-ი	Elfenbein
დეოფალ-ი	Königin, Herrin; Königin, Herrin
დიოფალთ-დიოფალ-ი	Königin der Königinnen
პურისა უფალ-ი	Tischherr
დეუფალ-ი	Königin, Herrin; Königin, Herrin
ნავისუფალ-ი	Schiffsbesitzer
პურისუფალ-ი	Tischherr
სეფექალ-ი	Magd am Königshof; Hofdame
ზღჳსქალ-ი	Meerjungfrau
სავაღალ-ი	Faden, Netz
ნაბერწყალ-ი	Funke
თანასძალ-ი	Schwägerin
მარილმხალ-ი	eine Art Gemüse
ნაკუარცხალ-ი	Glut, brennende Kohle
თხრებლ-ი	Grube, Graben; Grube, Graben
ზომთსაბელ-ი	Maßband, Seil
ჴამლისსაბელ-ი	Schnürsenkel
მანქანისსაბელ-ი	Strick, Seil einer Vorrichtung
თანამნებებელ-ი	Bundesgenosse, Verbündeter
წინამქადაგებელ-ი	Prophet
წინაჲსწარმქადაგებელ-ი	Prophet
ოქროსაგებელ-ი	goldenes Bett
სიტყჳსსაგებელ-ი	Antwort-, Entgegnung
თანადამბადებელ-ი	Mitschöpfer
ღაღადისმგდებელ-ი	Nachrichtenübermittler, Bote
სახელისმდებელ-ი	Namensgeber
რჩულისმდებელ-ი	Gesetzgeber; Gesetzgeber
შჯულისმდებელ-ი	Gesetzgeber; Gesetzgeber
საბუდებელ-ი	Nest
ზეგარდამოსატევებელ-ი	herabzulassend; Wasserfall
წინასაკუეთებელ-ი	Küste
ნავისმართებელ-ი	Steuermann
სიტყჳსგამომეძიებელ-ი	Diskussionsgegner
შურისმეძიებელ-ი	Rächer
საბრალებელ-ი	Verbrecher, Anzuklagender, Erbarmungswürdiger
მაჩივლებელ-ი	Angeklagter
შეუფარილებელ-ი	ohne Haar, ohne Fell
განუმხილებელ-ი	Geheimnis
მწიგნობართშემყვანებელ-ი	Schriftsekretär
წერილისშემომყვანებელ-ი	Schriftgelehrter, Gesetzesgelehrter
მთარგმანებელ-ი	Erklärer, Kommentator
ნაწილისშთასასუენებელ-ი	Reliquienschrein
განსაშუენებელ-ი	Schmuck
სინანულისამჩუენებელ-ი	Bereuender, Reumütiger
ისრისსაყენებელ-ი	Bollwerk
ნავისმაშენებელ-ი	Schiffbauer
გოდლისმაშენებელ-ი	Turmerbauer
საპოვნებელ-ი	zu findend, Verzeichnis
გასაკუთნებელ-ი	Eigentum
დედისმაგინებელ-ი	Beschämer der Mutter
მამისმაგინებელ-ი	beschämend / Schande für den Vater
სადინებელ-ი	Rinnsal, Rinne
ნავისმავლინებელ-ი	Steuermann
აღსაორძინებელ-ი	Erzieher
აღუორძინებელ-ი	ohne Hinzufügung
საქორწინებელ-ი	Hochzeits-
წინააღმდგომობისმქონებელ-ი	Gegner
შესაცხუნებელ-ი	glutheißer Ort
ქარისმოსაფარებელ-ი	Windschutz
მსერებელ-ი	Esser
სამწერებელ-ი	langstieliger Fächer
ხარკისმკრებელ-ი	Steuereintreiber
თესლისმკრებელ-ი	Schwätzer
წყლისმკრებელ-ი	Wasserträger
ჰომისმკრებელ-ი	Abtrünniger, Aufständischer
მსტუმრებელ-ი	Gastgeber
თანამცხორებელ-ი	zusammenlebend, Gatte, Gattin
საფანდურებელ-ი	Panduri
წიგნისმიმღებელ-ი	Briefbote
ქვისსატყორცებელ-ი	Steinschleudervorrichtung; Steinschleudervorrichtung
მზრახებელ-ი	beratend, Berater
მავასხებელ-ი	Geldverleiher
სავასხებელ-ი	Kredit
საწდობელ-ი	Amboß
სანათობელ-ი	Leuchte, Lämpchen
მსახიობელ-ი	Gaukler
წინამგალობელ-ი	Vorsänger
ღმრთისმგალობელ-ი	Gottesverehrer, Gottesverherrlicher
უგალობელ-ი	Melodielosigkeit
სანათლობელ-ი	Fenster, Lichtöffnung
ცჳლისმადნობელ-ი	Wachsschmelzer
სარკინობელ-ი	Ringkampfstätte
თანამსერობელ-ი	Abendbrottischgenosse
სამსტურობელ-ი	Ausguck, Beobachtungsort
ჴელისსაპყრობელ-ი	in der Hand zu haltend; Schwert; in der Hand zu haltend; Schwert
მერთისა მპყრობელ-ი	Pantokrator; Pantokrator
სოფლისმპყრობელ-ი	Landesherrscher, Provinzherrscher
საყდრისმპყრობელ-ი	Bischof
წინაგანსაწყობელ-ი	Kampfes-
ღმრთიმშობელ-ი	Muttergottes; Muttergottes
ღმრთისმშობელ-ი	Muttergottes
მბჭობელ-ი	Richter
ჴდალთმდრანჯობელ-ი	geil auf ein Weibchen
ჴდალთმნდრანჯობელ-ი	geil auf ein Weibchen; geil auf ein Weibchen
დუბელ-ი	Schüttelfrost
ჩარადელ-ი	Pickel, Eiterbläschen
ყურგდელ-ი	Hase; Hase
ვეცხლისმჭედელ-ი	Silberschmied
ოქროჲსმჭედელ-ი	Goldschmied
ზღჳსკიდელ-ი	Bewohner der Meeresküste
გამსყიდელ-ი	Verkäufer
განმსყიდელ-ი	Verkäufer, Händler
მომსყიდელ-ი	Käufer
კერმისმსყიდელ-ი	Kupfergeldwechsler
კაცისმსყიდელ-ი	Menschenhändler
წარსაწყმენდელ-ი	zu verlierend, zu vernichtend, Verderben; zu verlierend, zu vernichtend, Verderben
შეშისმკოდელ-ი	Holzfäller
ჩჩჳლთმზრდელ-ი	Säuglingserzieherin
ცხოვართმზრდელ-ი	Schafhirt, Viehhirt
საცხოვართმზრდელ-ი	Viehzüchter
საცხოვრისმზრდელ-ი	Viehhirt, Schafhirt
მყუდელ-ი	Wächter, Beschützer
არამღდელ-ი	Nichtpriester
მთავარმღდელ-ი	Oberpriester, Presbyter
ყურყდელ-ი	Hase; Hase
ხარკისმიმჴდელ-ი	Steuereintreiber
ხარკისმომჴდელ-ი	Steuereintreiber
საჴნველისმზიდველ-ი	Pflugzieher
წინამცოდველ-ი	früherer Sünder
ეტლთმარბეველ-ი	Teilnehmer am Wagenrennen
აბჯრისდამაბნეველ-ი	Waffenverlierer, Waffenstrecker
სარეველ-ი	Steuer
გულისსარეველ-ი	Unkraut
საქმისმაწუეველ-ი	zur Arbeit aufrufend, Aufseher
თავისსახუეველ-ი	Kopftuch
თანაგამომრჩეველ-ი	Ratgeber, Berater
თუალთა მაქცეველ-ი	Zauberer, Hexer
წისქჳლისმაქცეველ-ი	Mühlraddreher
სიტყჳსუკუნმქცეველ-ი	Diskussionsgegner
ღუედისმხეველ-ი	Lederbearbeiter
ტყავისმხეველ-ი	Fellschneider
ტაბაკისმთხზველ-ი	Pfannenmacher
სელისმრთველ-ი	Flachsspinner
მნათლველ-ი	taufend, Täufer
თუალითმხილველ-ი	Augenzeuge
თანაგანმხილველ-ი	Gewissen
წინაჲსწარმხილველ-ი	Hellseher
ჩუენებისმხილველ-ი	Traumseher
ძმათმკლველ-ი	Brudermörder
თჳთმკლველ-ი	Selbstmörder
კაცისმკლველ-ი	Mörder
მენელსაცხებლეთმგბოლველ-ი	Salben-, Tinkturen-, Spezereienkocher
საცხებლისმგბოლველ-ი	Salbenzubereiter
ნელსაცხებლისმგბოლველ-ი	Arzneizubereiter
საგულველ-ი	Wunsch
მჴედართმძღუანველ-ი	Feldherr; Feldherr
საფლავისმტყუენველ-ი	Grabräuber
სამუნველ-ი	zur Beseitigung der Krätze
დასასტჳნველ-ი	Blasinstrument
შესაბრძჳნველ-ი	Verschluß (der Kleidung)
სელისმქსოველ-ი	Leinweber
მისათხოველ-ი	Braut
წარმპარველ-ი	Dieb, Räuber
წინასაფარველ-ი	zu bedeckend, Schutz-
პირისსაფარველ-ი	Schleier
მკერველ-ი	nähend, Schneider; nähend, Schneider
ნავისსახერველ-ი	Schiffssteuer
თავუბურველ-ი	mit unverhülltem Kopf
შფოთისაღმძრველ-ი	Aufrührer, Aufständischer
გარემოსათესველ-ი	Feld
თავუპარსველ-ი	mit unrasiertem Kopf
კართსაჴსველ-ი	Schloß
ბაგინისმძარცუველ-ი	Plünderer eines heidnischen Tempels
სამარისმძარცუველ-ი	Grabräuber
ყოვლადდასაწუველ-ი	ganz zu verbrennendes Opfer
მრეშველ-ი	Holzhacker
მესაპყრობილეთმცველ-ი	Gefängniswärter
კართმცველ-ი	Türwächter, Pförtner
მთავარმცველ-ი	Wachtmeister
ტაძრისმცველ-ი	Palastwächter
გარემოჲსმცველ-ი	Leibwächter
მძუარცველ-ი	Räuber
ცილისმფუცველ-ი	Meineidiger
საფუნძველ-ი	Grundlage, Fundament; Grundlage, Fundament
მუხუნძველ-ი	Seidenraupe
საფურძველ-ი	Grundlage, Fundament; Grundlage, Fundament
სიწმიდეთმკრეხველ-ი	Plünderer von Heiligtümern
სამღდელოთმკრეხველ-ი	Entwender von Kirchengut, diebischer Priester
ულუკთმკითხველ-ი	Wahrsager
წიგნისმკითხველ-ი	Vorlesender (in der Liturgie)
სამოთხველ-ი	Ort zum Spazierengehen
სამარხველ-ი	aufzubewahrend, zu behütend; Grab; aufzubewahrend, zu behütend; Grab
სჯულისმმარხველ-ი	Gesetzeshüter
შჯულისმმარხველ-ი	Gesetzeshüter
მარმარილოჲსმხერხველ-ი	Marmorbearbeiter
საწურთელ-ი	Lehr-, zu lehrend, Schule
სიბრძნისსაწურთელ-ი	Weisheitsschule
ყრმათმწურთელ-ი	Lehrer, Pädagoge
ჩჩჳლთმწურთელ-ი	Säuglingserzieherin
კიცუთმწურთელ-ი	Fohlenabrichter
ურვიელ-ი	in Not / Bedrängnis
სიკარიელ-ი	Räuber
პონტიელ-ი	Mann / Frau vom Pontos
ქვისსათლელ-ი	Vorrichtung zur Steinbearbeitung
თანამჭამელ-ი	Tischgenosse
უჟამოდმჭამელ-ი	Vielfraß
სოფლისშემჭამელ-ი	Weltvernichter
ნაწლევთმჭამელ-ი	Innereienesser
შესაწირავისმჭამელ-ი	Opfergabenesser
მკალისმჭამელ-ი	Heuschreckenfresser
თესლისმჭამელ-ი	Sämereienesser, Gemüseesser
მძორისმჭამელ-ი	Aasfresser
მიწისმჭამელ-ი	Erdfresser
ყელისსაბმელ-ი	Kette, Halsschmuck
ხარკისმიმცემელ-ი	Steuerzahler
შიგნითგამომცემელ-ი	Verräter
ნიჩბისმცემელ-ი	Steuermann
ხარკისმცემელ-ი	Steuerzahler
წამლისმცემელ-ი	Arzt
პურისმცემელ-ი	Fütterer
ხუარაზმელ-ი	Choresmier
შოვამდგომელ-ი	Vermittler
ზემდგომელ-ი	Aufseher
წინააღმდგომელ-ი	Gegner, Widersacher; Gegner, Widersacher
პირველადსაჯდომელ-ი	Vorsitz, Ehrenplatz
ქუეყანისსაზომელ-ი	Bodenvermesser
ქუეყანისმზომელ-ი	Geometer
ვეცხლისმშრომელ-ი	Silberschmied
ქუეყანისმშრომელ-ი	Bauer
ქუეწარმძრომელ-ი	Reptil; unten kriechend, lahm; Reptil; unten kriechend, lahm
საფსმელ-ი	männliches Glied
შემწეობისმომრთუმელ-ი	Helfer
წიგნისმრთუმელ-ი	Briefüberbringer
წყლისსასუმელ-ი	Wasserbecken
ღჳნისმსუმელ-ი	Weintrinker, Trunkenbold
ყრმისაღმქუმელ-ი	Hebamme
ფერჴთშესაცუმელ-ი	Schuh
მატლთსაჭმელ-ი	Wurmfutter
ფსალმუნთშემასხმელ-ი	Psalmensänger
ფერჴთშესასხმელ-ი	Schuh
ფერჴთსასხმელ-ი	Schuh
მერცხლისგამსხმელ-ი	schwalbenjagender Vogel
წყლისმსხმელ-ი	Wassereingießer
იერუსალჱმელ-ი	Jerusalemer
მხჳმელ-ი	Mehl für das Weihbrot
ჴელგანჴმელ-ი	mit gelähmter Hand
ცხოვართსაბანელ-ი	Schafbadestelle
ჰეროდიანელ-ი	Anhänger des Herodes
წყალთგარდამოსაქანელ-ი	Wasserrinne
წარსაქანელ-ი	Etmal, in einem Tag zu durchfahrende Strecke auf See (80 Meilen)
წელთდამკბენელ-ი	Darmentzündung
შესასმენელ-ი	anzuzeigend, Beweismittel
შთასადინელ-ი	Becken zur Aufnahme von Flüssigkeit
წყალთსადინელ-ი	Wasserrinne
მისადინელ-ი	Rinne
გამოსადინელ-ი	Rinne; Ader
მისაძინელ-ი	Ruhestätte, Grab
გამომთარგმნელ-ი	Erklärer, Kommentator
ნიშთმზმნელ-ი	Wahrsager, Zeichendeuter
ქვისმქმნელ-ი	Steinmetz
შთასარღუნელ-ი	Flüssigkeitsbehälter
საძღუნელ-ი	zu überreichend, Geschenk
მყნელ-ი	pfropfend, Pfropfer
ჰინდოელ-ი	Inder
სათოელ-ი	Maß (für Korn und Getreide)
სელისმქსოელ-ი	Leinweber; Leinweber
მისათხოელ-ი	Braut; Braut
პურისმთხოელ-ი	Bettler
ეშმაკთსაყუარელ-ი	Teufelsliebling
მწერელ-ი	Schriftsteller, Schreiber
გარდამწერელ-ი	Abschreiber; Abschreiber
სძლისმომგურელ-ი	Freund des Bräutigams
ბნელისგანმყრელ-ი	Zerstreuer der Finsternis
თანადშესამოსელ-ი	Kleidung
საკურთხევლისშესამოსელ-ი	Altartuch
ტანისშესამოსელ-ი	Kleidung
ტანისსამოსელ-ი	Kleidung; Kleidung
წიგნისმმოსელ-ი	Buchbinder
მკუდრისმმოსელ-ი	Totenbekleider
მწყსელ-ი	Hirt, Hüter, Dresseur
მომწყსელ-ი	Hüter, Hirt
ნიშთმჭურეტელ-ი	Wahrsager
ისრაიტელ-ი	Israelite
ისრაჱლიტელ-ი	Israelite
სდუელ-ი	Pflücken, Weinlese; Monatsname (etwa Oktober); Pflücken, Weinlese; Monatsname (etwa Oktober)
წინაწარმეტყუელ-ი	Prophet
ცრუვწინაწარმეტყუელ-ი	falscher Prophet
ცრუწინაწარმეტყუელ-ი	falscher Prophet
წინაჲსწარმეტყუელ-ი	Prophet; Prophet
ქებისმეტყუელ-ი	Preissänger
ღმრთისმეტყუელ-ი	Theologe
თესლისმეტყუელ-ი	Schwätzer
სახისმეტყუელ-ი	Gleichniserzähler, Fabelerzähler
მეტსმეტყუელ-ი	Schwätzer
მრეშუელ-ი	Holzhacker
ტყისმკაფელ-ი	Holzfäller
შეშისმკაფელ-ი	Holzfäller
საწაფელ-ი	Zaum, Zügel; Steuer
თანასაყოფელ-ი	mitbewohnend, Nachbar
ქუეყანითმყოფელ-ი	Wahrsager
მძლავრმყოფელ-ი	Vergewaltiger
დედაქალაქელ-ი	Hauptstädter
პერექელ-ი	Tuch zum Abdecken von Kirchengefäßen
საშჩელ-ი	Strafe, Strafmaß, Gericht, Urteil; Strafe, Strafmaß, Gericht, Urteil
საკუეცელ-ი	Schneidemesser
ვცელ-ი	weit, breit, geräumig; Teil der Hüfte; weit, breit, geräumig; Teil der Hüfte
ჴელთსაჴოცელ-ი	Handtuch
ღელვავრცელ-ი	große Erregung; Fußnotensymbol
დედისმუცელ-ი	Mutterbauch, Mutterleib
წჳვგრძელ-ი	mit langem Unterschenkel
სავრძელ-ი	Sessel, Stuhl
ხატთმლეწელ-ი	Bilderstürmer
კეცისჭურჭელ-ი	Tongefäß
ოქროჲსჭურჭელ-ი	Goldschmuck
წინააღდგომმსჯელ-ი	Streiter, Kläger
განმშჯელ-ი	richtend, Richter
სახელტკბილ-ი	mit angenehmem / glücklichem Namen
ნაყოფტკბილ-ი	gute Frucht
თმაგარდატეობილ-ი	mit herabgelassenem Haar; mit herabgelassenem Haar
ფურცელდაჭნობილ-ი	mit verwelkten Blättern
წინაგანწყობილ-ი	gegnerisch, Feind
სიცბილ-ი	Verrücktheit, Dummheit, Heimtücke
აჩდილ-ი	Schatten, Dämmerung, Beispiel; Schatten, Dämmerung, Beispiel
თითწარჴდილ-ი	mit abgefallenen Fingern
სულნელყუავილ-ი	duftende Blume
ქათმისყივილ-ი	Hahnenschrei
შეჩივილ-ი	Klage
შემოჩივილ-ი	Klage
იფქლვილ-ი	Weizen
ყოვილ-ი	Blume, Blüte; Blume, Blüte
თავდაბურვილ-ი	mit verhülltem Kopf
მისურვილ-ი	Wunsch
ტყუვილ-ი	Lüge, Lügen
შვილისშვილ-ი	Enkelkind
შჳვილ-ი	Lärm, Getöse
ჴელთბორკილ-ი	Handfesseln
თანაყოლილ-ი	folgend, Anhänger
ზედდადგრომილ-ი	Aufseher
სიყრმილ-ი	Hunger; Hunger
სიყუმილ-ი	Hunger; Hunger
უკურჩენილ-ი	übriggeblieben, Gewinn
მეძავქმნილ-ი	Hure
ყამირქმნილ-ი	verwildertes Feld
სანდალგანჴსნილ-ი	mit offenem Schuhwerk
ზედადაწერილ-ი	Inschrift
ზედაწერილ-ი	Inschrift, Aufschrift
მოტირილ-ი	Weinen
ფურცელდაყრილ-ი	mit abgefallenen Blättern
მწყსილ-ი	Gemeinde
წენტილ-ი	Punkt; Punkt
მუილ-ი	Gebrüll; Gebrüll
შეტყუილ-ი	lügen, Lüge; lügen, Lüge
ქადაგყოფილ-ი	ehemaliger Prediger
მჭკუერველყოფილ-ი	ehemaliger Dieb
წყალტფილ-ი	warmes Wasser
წინამიკუეცილ-ი	mit geschorenem Haar
საძილ-ი	Schlaf-
ზურგტეხილ-ი	mit verletztem Rückgrat
ზურგგანტეხილ-ი	mit gebrochenem Rückgrat
ნავგანტეხილ-ი	Schiffbrüchiger
მწყერმარჴილ-ი	Wachtel
მყუდოლ-ი	Wächter, Beschützer
ფაკეოლ-ი	Kopftuch, Faziale; Kopftuch, Faziale
კრასოვოლ-ი	Becher; Becher
ჰოლოლ-ი	Uhu, Eule, Kauz
კლდისსასროლ-ი	Steingeschoß
სამტოლ-ი	eine Art Kraut
ძმისცოლ-ი	Schwägerin
ძისცოლ-ი	Schwiegertochter
ბრძოლ-ი	kämpfend, Kämpfer
წინასაბრძოლ-ი	Festung
ზღუდისსაბრძოლ-ი	Vorrichtung zur Mauerzerstörung
ქუეითმბრძოლ-ი	Fußsoldat
ჭურვილმბრძოლ-ი	bewaffneter Kämpfer
მრავალთესლ-ი	viele Stämme / Völker
ჰურიაულ-ი	jüdisch, jüdischen Glaubens
მკრდისსამკაულ-ი	Brustschmuck
მთავარმზარაულ-ი	Oberkoch
კერძოდღესასწაულ-ი	ein Teil der Feiertage
კასტაბულ-ი	ein Maß
ტაბასტაკდაგებულ-ი	Tafeldecker
ოქროწახნაგებულ-ი	mit Goldkante
სიტყუაგებულ-ი	Antwort
სიძვებულ-ი	Huren-
ბელზებულ-ი	Satan, Teufel
ბერზებულ-ი	Satan, Teufel; Satan, Teufel
კეთილადჴსენებულ-ი	seligen Andenkens
პირველაღმოცენებულ-ი	Sproß, Trieb
მრავალვნებულ-ი	in äußerster Not
მუცელსქონებულ-ი	Embryo
ხარჭოსნებულ-ი	Nebenfrau
კუართდაპებულ-ი	mit zerrissener Kleidung
სამოსელდაპებულ-ი	mit zerrissener Kleidung
თანადამკჳდრებულ-ი	Gatte, Gattin
ერადგანწესებულ-ი	Soldat
პირაღებულ-ი	mit offenem Mund
განგონჯებულ-ი	Aussätziger
დაჩხიბულ-ი	Zauber-
მობაგულ-ი	obere Türeinfassung
სიძაგულ-ი	Abscheu, Ekel
ოქრონაკადულ-ი	goldverströmend, mit Gold strömend; Redner
ღმრთისმოკიდულ-ი	Anhänger Gottes
ღჳნისსაფარდულ-ი	Weingeschäft
ვეცხლითმოფარდულ-ი	Silberhändler
თესლისმოფარდულ-ი	Geldwechsler
ძოწეულისმოფარდულ-ი	Purpurgewandhändler
ოცდაათეულ-ი	dreißigfach, Dreißigstel; ein Maß
მათეულ-ი	ihr / deren Verwandter
მემთეულ-ი	Berg-, Gebirgs-
სამწყრთეულ-ი	drei Ellen
ორწყრთეულ-ი	zwei Ellen
დიეკეულ-ი	Färse, weibliches Rind oder Kalb
მტკავლეულ-ი	Spanne
ვეცხლეულ-ი	Silbergeld
მამისმამეულ-ი	Nachkommenschaft
ჟამეულ-ი	Zeit-
ტომეულ-ი	Landsmann
ჩუენეულ-ი	Unsriger
ტევნეულ-ი	Weintraube
დრაჰკნეულ-ი	Drahkan
თანაცხედრეულ-ი	Gatte, Gattin
თუეულ-ი	Monats-
ზღუდედარღუეულ-ი	zerstörte / eingestürzte Mauer
მეფეულ-ი	Königreich
მერჩულიულ-ი	Mertschuli-Versmaß
სიწყალულ-ი	Mitleid, Barmherzigkeit
ახილულ-ი	mit geöffneten Augen
თივამეწამულ-ი	rotes Kraut
ცისად-ცისადგუემულ-ი	Mondsüchtiger, Schlafwandler
ღჳნოსუმულ-ი	Weintrinker
ფიცარმოსხმულ-ი	Bretter-
კიდექმნულ-ი	getrennt, entfernt; Eremit
ჴელითქმნულ-ი	von Hand geschaffen; Götzenbild
უღონოქმნულ-ი	in Not
სამთავროქმნულ-ი	Untertanen-
ვეცხლისსიყუარულ-ი	Liebe zum Geld
სიბრძნისსიყუარულ-ი	Weisheitsliebe
ბნელისმოხარულ-ი	erfreut über die Finsternis
სტრატულ-ი	Kutscher, Wagenlenker
ცრუმოციქულ-ი	falscher Apostel
მღულ-ი	Sichel
შჩულ-ი	Gesetz, Glauben; Strafe
სეფეწულ-ი	Höfling, Vornehmer am Königshof
დედისდისწულ-ი	Kousin, Kousine
შვილისწულ-ი	Enkelkind
სახლისწულ-ი	Kind der Magd (vom Hausherrn)
მამისძმისწულ-ი	Kousin, Kousine
ძისწულ-ი	Enkelkind
მშაჯულ-ი	Richter; Richter
სხუაშჯულ-ი	Bekenner eines anderen Glaubens
ჭროფლ-ი	Sommersprossen
სავაღლ-ი	Faden, Netz; Faden, Netz
ისრაჱლ-ი	Israel, Israelite
წრჳლ-ი	klein, dünn, eng, Stückchen; Kleingeld; klein, dünn, eng, Stückchen; Kleingeld
მონოქსჳლ-ი	Einbaum
კერტჩჩჳლ-ი	mit frischen Knospen
ბარკალსხჳლ-ი	Schenkel
სახისდასაბამ-ი	Muster, Beispiel
სახელითმოდგამ-ი	Namensvetter
საქმისმოდგამ-ი	Mitarbeiter
საყდრისმოდგამ-ი	Beisitzer
მღამ-ი	Fledermaus
სელისლელწამ-ი	Leinpflanze
ჰაჯამ-ი	Schröpfer, Bader
ჰამ-ი	Stock mit eiserner Spitze
სირაქლემ-ი	Vogel Strauß
ნაგურემ-ი	geschlagen, Wunde
საყჳრისმცემ-ი	Hornbläser
მწემ-ი	Jüngster; gehorsam, untergeben; Jüngster; gehorsam, untergeben
რასიმ-ი	Leibwache
თანადამდგომ-ი	Helfer
წინაშემდგომ-ი	vorn stehend, Vorsteher
წილისსაზომ-ი	Maß
უცხოტომ-ი	fremdstämmig, Ausländer
წინამძღომ-ი	Führer, Anführer
ვარმ-ი	über dem Kettenhemd zu tragendes Kleidungsstück
აღნუმ-ი	Heerschau, Parade
ტოჰმ-ი	Stamm, Volk, Geschlecht
კბჳშტაბან-ი	Armreif; Baum Peridexion (Esche)
შუვაუბან-ი	Mittelplatz
მცირათაგან-ი	eins von den sehr Geringen
ზეცისათაგან-ი	einer von den Himmlischen
მჯობეთაგან-ი	einer von den Besseren; einer von den Besseren
მეაჩრდილეთაგან-ი	einer von den Schauspielern
მესიზმრეთაგან-ი	einer von den Traumdeutern
დიდებისმბორგელთაგან-ი	einer von den Ehrgeizigen / Ruhmsüchtigen
წინაწარმეტყუელთაგან-ი	einer der Propheten
ჰეროდიანთაგან-ი	einer von den Anhängern des Herodes
სპონდიონთაგან-ი	einer von den Mönchen
პაპისპაპთაგან-ი	ein Nachkomme
არამდიდართაგან-ი	von den Armen
მდაბიორთაგან-ი	einer von den Dörflern
მიზდურთაგან-ი	einer von den Eingestellten
ფილასოფოსთაგან-ი	einer von den Philosophen
წინადაცუეთილებისაგან-ი	einer von den Beschnittenen
სამგუამოვნებისაგან-ი	ein Glied der Dreifaltigkeit
ჭეშმარიტებისაგან-ი	einer von den Wahrhaftigen
ნათესვობისაგან-ი	einer von den Verwandten
დაჴსნილობისაგან-ი	einer von den Furchtsamen / Trägen
უანდერძოობისაგან-ი	einer von den Testamentlosen
ზოგისაგან-ი	Teil
ეშმაკისაგან-ი	einer von den Teufeln
უანდერძებელისაგან-ი	einer von den Testamentlosen
ზესკნელისაგან-ი	einer von den Himmlischen
სოფლისაგან-ი	einer von den Irdischen
საჴმარისაგან-ი	einer von den Gegenständen
საჴმრისაგან-ი	einer von den Gegenständen
დღისაგან-ი	Tages-
ზეცისაგან-ი	einer von den Himmlischen
ეზოჲსაგან-ი	Hof-, Haus-
ორითწლითგან-ი	von zwei Jahren an und jünger, im Alter unter zwei Jahren
ორიწლისაჲთგან-ი	von zwei Jahren und jünger, im Alter unter zwei Jahren
თქუენგან-ი	einer von euch / Ihnen
რამადან-ი	islamischer Fastenmonat
ებრაეან-ი	Jude
უბეან-ი	Meeresbucht
ჰეროდეან-ი	Anhänger des Herodes
ქვეან-ი	steinig, Stein-
ისრაჱლეან-ი	Israelite
ფესუეან-ი	mit Wurzeln / Fransen
უშტეკავან-ი	Steinschleuder
მსულევან-ი	ungesäuertes Brot
ცომევან-ი	Sauerteig
დანაკისკუდოვან-ი	Dattelpalmenhain, -land; Phönizien
კაცისთავოვან-ი	eine Waffenart
მიზეზოვან-ი	Verbrechen; Vorwand
ჭალაკოვან-ი	Insel-, mit Insel(n)
გუნდრუკოვან-ი	Weihrauch, Weihrauch-
შესავალოვან-ი	Vorwort-, mit einem Vorwort
ველოვან-ი	Feld, Wiese
სიტყჳთჴელოვან-ი	Schönredner, Orator
ნაწილოვან-ი	Teil
ზეთისხილოვან-ი	Olivenhain
მროწეულოვან-ი	Granatapfelgarten
სამგუამოვან-ი	Dreifaltigkeits-, Dreieinigkeits-
მეფხანოვან-ი	an Hautjucken Erkrankter; an Hautjucken Erkrankter
ჰუნოვან-ი	Reiter
მქჳშროვან-ი	kiesig, Kies-; kiesig, Kies-
ოქროფესოვან-ი	mit Goldsaum
ურნატოვან-ი	Furche, Acker
ნესუხავარტოვან-ი	Zuckermelonengarten
ნიშოვან-ი	Wunder
მქჳშოვან-ი	kiesig, Kies-
ყრმათმყვან-ი	Lehrer, Pädagoge
ჰეროდიან-ი	Anhänger des Herodes; Anhänger des Herodes
ტანწყლიან-ი	schön von Wuchs
ყანიან-ი	Feld-
ბაგრატუნიან-ი	Bagratide
ოლჳმპიან-ი	Olympiasieger
მატიან-ი	Chronik, Geschichtsbuch; Chronik, Geschichtsbuch
მირაკან-ი	Monatsname (etwa März); Monatsname (etwa März)
მეჰრაკან-ი	Monatsname (etwa März); Monatsname (etwa März)
ოქრომელან-ი	Goldtinte
შაჰრამან-ი	ahrevar (pers. Monatsname)
ვარსკულაოან-ი	Sternen-; Sternen-
წყურნობოან-ი	nasser Ort, Sumpf
წარბოან-ი	mit dichten Augenbrauen
წიდოან-ი	schmutzig, in der Menstruation; schmutzig, in der Menstruation
ხერდოან-ი	Geröllstelle
ზღუდოან-ი	Mauer-, Wall-; Mauer-, Wall-
უბეოან-ი	Meeresbucht; Meeresbucht
ზეთისხეოან-ი	Olivenhain
თავთავოან-ი	einzelne Kapitel
ვარსკულავოან-ი	Sternen-
მრგლოან-ი	Rund-; altgeorg. Rundschrift, Asomtavruli; Rund-; altgeorg. Rundschrift, Asomtavruli
ჴელოან-ი	Meister, Handwerker, Heilkundiger; Meister, Handwerker, Heilkundiger
წისქჳლოან-ი	Mühlen-
ცომოან-ი	Sauerteig; Sauerteig
ლერწმოან-ი	Schilf-, schilfbestandener Ort
ბოსტნოან-ი	Gemüsegarten
სამაროან-ი	Friedhof
მუშკატროან-ი	Duftstoffgefäß
ნაყროან-ი	unersättlich, Vielfraß; fett, fettig; unersättlich, Vielfraß; fett, fettig
რქოან-ი	Horn-
ლეღოან-ი	Feigenhain; Feigenhain
მჴეცოან-ი	Aufenthaltsort wilder Tiere
ვენაჴოან-ი	Weingarten; Weingarten
რან-ი	Bewohner von Ran (georg. Provinz)
ღამისყორან-ი	Nachtrabe
ჭლიკოსან-ი	Huf-, mit Hufen
ყუავილოსან-ი	blumig, Blumen-
ჰორლოსან-ი	Lanzenträger
სქემოსან-ი	Mönch
ღმრთივგჳრგჳნოსან-ი	von Gottes Gnaden gekrönt, Herrscher, König
ძონძოსან-ი	in Lumpen Gekleideter
ჩაბალახოსან-ი	Helmträger
კუერთხოსან-ი	Stabträger
მჴედართმძღუან-ი	Feldherr
ლაშქრისმძღუან-ი	Feldherr
სარღან-ი	Korb; Korb
ხუეიშან-ი	Flehen, Gebet; Bote; Flehen, Gebet; Bote
ჰან-ი	Großmutter
საკრებო-ჲ წიგნ-ი	Versammlungsprotokoll
ფალლენ-ი	Wal
ნაგრტენ-ი	Feder; Feder
სათთუენ-ი	Gesangsbuch, Menea
ნარღუენ-ი	Aufgewirbeltes, Getrübtes
პირველაღმონაცენ-ი	Sproß, Trieb
დივცააზნ-ი	Held göttlicher Abstammung
ქერაბინ-სერაბინ-ი	Cherubim und Seraphim
კბჳშტაბინ-ი	Armreif; Baum Peridexion (Esche)
სიბინ-ი	Spieß, Jagdspieß
სერობინ-ი	Seraphim
კჳშტობინ-ი	Armreif; Baum Peridexion (Esche); Armreif; Baum Peridexion (Esche)
მოაქამდინ-ი	bis zu dieser Zeit
მეექუსემდინ-ი	bis zum Sechsten
ტირისდინ-ი	Monatsname (etwa November-Dezember); Monatsname (etwa November-Dezember)
სევინ-ი	Teil der Dattelpalme; Stoff aus Palmenfasern; Teil der Dattelpalme; Stoff aus Palmenfasern
მაღდალინ-ი	Magdalena
კორტალინ-ი	Gefolgsmann
პიტჳოკაპინ-ი	Fichtenraupe
სალპინ-ი	ein Blasinstrument
დარეჩინ-ი	Zimt
თაგუქურცინ-ი	Wiesel
სერაბინ-ქერაბინნ-ი	Seraphim und Cherubim
კნინდონ-ი	Weingefäß (aus Ton)
ლეგეონ-ი	Legion
არავონ-ი	Pfand
ტრივონ-ი	Tribun, Heerführer; Tribun, Heerführer
მოლოზონ-ი	Mönch, Nonne; Mönch, Nonne
ჳაკინთონ-ი	Hyazinth (Edelstein); kostbares; Hyazinth (Edelstein); kostbares Gewebe
ზმარაგდიონ-ი	Smaragd
ფალკიდიონ-ი	kopfabschlagende Sense
კნიდიონ-ი	Weingefäß (aus Ton); Weingefäß (aus Ton)
ბირილიონ-ი	Beryll
ბჳრილიონ-ი	Beryll; Beryll
მარმარიონ-ი	Marmor
პორფირიონ-ი	ein Vogel
ილეკტრიონ-ი	Baumharz; Elektron; Baumharz; Elektron
ილიკტრიონ-ი	Baumharz; Elektron
დესიონ-ი	Daisios (griech. Monatsname)
პირიდექსიონ-ი	Baum Peridexion, Esche
ჳპატიონ-ი	Hypatios (byz. Titel)
იკტიონ-ი	Gableweihe
ინდიკტიონ-ი	Indiktion
ინსტიტუტიონ-ი	Institutio, Buch des Kirchenrechts
ოფტიონ-ი	Aufseher
პანდუქიონ-ი	Herberge, Schenke; Herberge, Schenke
ონჳქიონ-ი	Onyx
პანდოჰიონ-ი	Herberge, Schenke; Herberge, Schenke
არქედიაკონ-ი	Oberdiakon
დედათდიაკონ-ი	Diakonissin
ჳპოდიაკონ-ი	Rang unter dem Diakon
ბასილიკონ-ი	Schlangenart
პრახტიკონ-ი	Rechnungsbuch
ლიველლონ-ი	Schwurbrief
ლიბანონ-ი	Weihrauch
ნეარონ-ი	Gesetz(esnovelle)
თიატრონ-ი	Theater, Vorstellungsort; Theater, Vorstellungsort
ილეკტრონ-ი	Baumharz; Elektron
ილიკტრონ-ი	Baumharz; Elektron
მიჰრონ-ი	Myrrhe
კჳრიელესონ-ი	Kyrieeleison
კირიელეისონ-ი	Kyrieeleison; Kyrieeleison
ამონატონ-ი	Amiant, Asbest; Amiant, Asbest
კაპატონ-ი	Seite, Blatt, Kapitel; Seite, Blatt, Kapitel
სეკრეტონ-ი	Haus des Erzbischofs
სარდონიტონ-ი	Karneolit
ქსჳსტონ-ი	überdachter Sportplatz
შემეფტონ-ი	farbiges Glas
დიპტჳქონ-ი	Diptychon; Liste der Personen, derer im Gebet gedacht werden soll
პრჳონ-ი	Heerführer
ზმჳრნ-ი	Myrrhe
ჰრაბუნ-ი	Lehrer, Meister; Lehrer, Meister
ტრივუნ-ი	Tribun, Heerführer
უცუნ-ი	eine Pflanze
კაეშნ-ი	Kummer
შჱნ-ი	besiedelt, erbaut; Siedlung
ყჳნ-ი	Stirn
პაპისპაპ-ი	Vorfahre, Urahn
კეიტვეშაპ-ი	Wal
ტოლიპ-ი	Speise aus grünem Gemüse
ღამისმჴმობარ-ი	Nachtrabe
ჰეჯიბთა მთავარ-ი	Obertürwächter
მეოთხედმთავარ-ი	Tetrarchos
მესაპყრობილეთმთავარ-ი	Gefängnisdirektor
მემარნეთმთავარ-ი	oberster Kellermeister
მეფასეთმთავარ-ი	Schatzmeister, Oberschatzwächter
ანგელოზთმთავარ-ი	Erzengel
მტარვალთმთავარ-ი	Oberfolterknecht
შესაკრებელთმთავარ-ი	Oberster einer Synagoge
მღრდელთმთავარ-ი	Bischof; Bischof
მღდელთმთავარ-ი	Bischof
მზარაულთმთავარ-ი	Oberkoch
ტომთმთავარ-ი	Stammesführer
სენაკაპანთმთავარ-ი	Oberwächter am Schlafgemach des Herrschers
საჭურისთმთავარ-ი	Obereunuch
სტრატიოტთმთავარ-ი	Feldherr
მოგუთმთავარ-ი	Oberpriester der Feueranbeter
ნიჭთმთავარ-ი	Finanzminister
ასომთავარ-ი	Großbuchstabe
შესაკრებლისმთავარ-ი	Oberster einer Synagoge
საპყრობილისმთავარ-ი	Gefängnisvorsteher
სოფლისმთავარ-ი	Landesherrscher, Provinzherrscher
ტოჰმისმთავარ-ი	Stammesführer
მერცხლისმდევარ-ი	schwalbenjagender Vogel
ზედამსტოვარ-ი	Späher, Spion; Späher, Spion
ნიშისმსტოვარ-ი	Wahrsager
ძუძუჲსმწოვარ-ი	Säugling
ცხოველთმხატვარ-ი	Lebendmaler
სიტყუამტყუვარ-ი	Lüge
ქრისტემტყუვარ-ი	Pseudochristus
სპათარ-ი	Feldherr
ქოთარ-ი	Haube (dekoratives Element)
ფასკიარ-ი	Verband, Binde
წინაკარ-ი	Vortür, Kirchentür
საკარ-ი	Tor
სიკარ-ი	Dolch
უბნისკარ-ი	Tor der Umfriedung
საკელარ-ი	Verwalter
ხარტოლარ-ი	Archivar
სქოლარ-ი	Angehöriger der Leibwache
ლურსმარ-ი	Nagel
ლუსმარ-ი	Nagel
ტყავისსაქმარ-ი	Ort der Fell- / Lederbearbeitung
ქველისსაქმარ-ი	Wohltätigkeit, Güte
ქუეყანისსაქმარ-ი	Bodenbearbeitung
პურისსაქმარ-ი	Brotbäckerei
ქუაბნარ-ი	höhlenreicher Ort
უღნარ-მაღნარ-ი	dichter Wald
მჴეცნარ-ი	Aufenthaltsort wilder Tiere
ფიჩხნარ-ი	dürres Buschwerk
საძოარ-ი	Weide; Weide
ძუძუჲსმწოარ-ი	Säugling
ცხოარ-ი	Schaf, Vieh; Schaf, Vieh
კელაბტარ-ი	große Wachskerze; große Wachskerze
ნოტარ-ი	Sekretär, Notar
პროტონოტარ-ი	Oberschreiber
მკუარ-ი	Fichte(nholz)
ზედამსტუარ-ი	Späher, Spion
მძღუარ-ი	Führer
სპათმძღუარ-ი	Feldherr
ერისმძღუარ-ი	Fürst, Feldherr
მესაპყრობილეთმოძღუარ-ი	Gefängnisdirektor
მეპურეთმოძღუარ-ი	Bäckermeister
ტრაპეზთმოძღუარ-ი	Tischherr
ნიორაკთმოძღუარ-ი	Anführer der Herolde
განმგებელთმოძღუარ-ი	Oberverwalter
მღდელთმოძღუარ-ი	Bischof, Katholikos, Hoherpriester
მზარაულთმოძღუარ-ი	Oberkoch
ჴელოვანთმოძღუარ-ი	Handwerksmeister
მწიგნობართმოძღუარ-ი	Oberschriftgelehrter
ხუროჲთმოძღუარ-ი	Oberbaumeister
რჩულისმოძღუარ-ი	Gesetzeslehrer; Gesetzeslehrer
შჯულისმოძღუარ-ი	Gesetzeslehrer
ეზოჲსმოძღუარ-ი	Fürst; Verwalter
ქარ-ცუარ-ი	Sturm
უეჭუარ-ი	zweifellos, ohne Zweifel
ცხენისფაფარ-ი	ein Wildkraut
მთავარქონდაქარ-ი	Oberkoch, Hauptkoch
ხაჩეცარ-ი	Anhänger des armenischen Glaubens; Fastenzeit der Armenier
თანამოფიცარ-ი	Mitverschwörer
ხუარბლისვაჭარ-ი	Weizenverkäufer
სათხარ-ი	Spaten
სახარებისაებრ-ი	Evangelien-
ერისთავებრ-ი	Soldaten-, Militär-
მკლველებრ-ი	Mörder-
განმცხრომელებრ-ი	zur Belustigung, zum Spaß
ძაღლებრ-ი	hündisch, Hunde-
სტრატიოტებრ-ი	soldatisch, Soldaten-
პირუტყუებრ-ი	tierisch, wie Nichtsprechende
მეუფებრ-ი	Reich, Königreich
ქალანდრ-ი	Bett
უდაბნოჲსმკჳდრ-ი	Einsiedler, Eremit
თანაბერ-ი	unterster Mönch
ოკდომბერ-ი	Oktober
ნოენბერ-ი	November; November
სამმნათობიერ-ი	Dreifaltigkeit
უმშუმინვიერ-ი	ohne Seele
შჳდთუალიერ-ი	mit sieben Edelsteinen
ჴელცალიერ-ი	mit leeren Händen
წმიდათამიერ-ი	Heiligen-
წერილთამიერ-ი	nach dem Alten Testament
სათნოებისამიერ-ი	Liebes-
სახარებისამიერ-ი	Evangelien-
ჩამორჩობისამიერ-ი	wie das Aufhängen
გულისწყრომისამიერ-ი	im Zorn
თქუენმიერ-ი	euer / Ihr
მოსჱსმიერ-ი	Buch Mose
რქაშუენიერ-ი	mit schönem Geweih
სახელშუენიერ-ი	mit schönem Namen
ღრმიადმეცნიერ-ი	Weiser
შჯულისმეცნიერ-ი	Gesetzeskundiger
წიგნისმეცნიერ-ი	Schriftgelehrter, Vorlesender (in der Liturgie)
სიტყჳსმეცნიერ-ი	redegewandt, Rhetor
დევტელერ-ი	Stellvertreter des Leiters / Bischofs / Abts; Stellvertreter des Leiters / Bischofs / Abts
თანამტერ-ი	Feind
ტანუტერ-ი	Abt, Hausherr eines Klosters
ლეღჳსკუერ-ი	getrocknete Feigen
პარითმემღერ-ი	Tänzer, Sänger
მრავალმგზავრ-ი	häufig Reisender
მჯავრ-ი	Strafe, Recht, Gerechtigkeit; Strafe, Recht, Gerechtigkeit
სკევრ-ი	Truhe
მუდბირ-ი	(Hell)seher, Wahrsager
პანაგირ-ი	Fest-, Marktversammlung
კბოდისპირ-ი	Felsklippe
მზისპირ-ი	sonniger Platz
მთისპირ-ი	Gebirge
ჰორლისპირ-ი	Speerspitze, Lanzenspitze
ისრისპირ-ი	Pfeilspitze
ზღჳსპირ-ი	Meeresküste
სარასირ-ი	Zaunkönig
ნაყშირ-ი	Kohle; Kohle
მამძირ-ი	uneheliches Kind
ნჳკრ-ი	Rotz
მმამრ-ი	Mann, männlich, Männchen
ჰამბორ-ი	Kuß; Kuß
მანდრაგორ-ი	Alraune
მდაბიორ-ი	Landbewohner, Dörfler, von niederem Stand; Landbewohner, Dörfler, von niederem Stand
თანამდაბიორ-ი	Dorfgenosse
იამორ-ი	Gazelle
ფაკტორ-ი	geschehen, getan; Faktor
პროტიკტორ-ი	Aufsicht, Königswächter
სკეპტორ-ი	Wasserreinigungsbecken
სჳნიღორ-ი	Rechtsanwalt
ნასხორ-ი	zu verspottend, Spott
მსხორ-ი	Opfer, Opfergabe
ალამბასტრ-ი	Glasgefäß; Glasgefäß
ტბურ-ი	kleiner See, Teich, Tümpel
მანდრაგურ-ი	Alraune; Alraune
უცხოთსადგურ-ი	Fremdenherberge
ნავისსადგურ-ი	Hafen
ოთხმიზდურ-ი	Tetrarch; Steuereintreiber
მეძვურ-ი	Huren-
თანამდაბიურ-ი	Dorfgenosse; Dorfgenosse
მანდიკურ-ი	Tragbeutel
მესუმურ-ი	Trinker
თასურ-ი	Becher-
შანფურ-ი	Bratspieß
ნაჩქურ-ი	übereilt, hastig, unüberlegt, Geschwätz
სიჩქურ-ი	Täuschung, Dummheit
ღჳძლისყურ-ი	Teil der Leber
ჴელითმსახურ-ი	Diener
მდღევრითმსახურ-ი	Tagelöhner
ეშმაკთმსახურ-ი	Teufelsdiener
ცეცხლისმსახურ-ი	Feueranbeter, Mazdaist
მსტჳრ-ი	Schalmeienbläser
პერიფრას-ი	Periphrase, Ausschmückung
თანამოყუას-ი	Freund
ყულყას-ი	ägyptische Erbse
უთანალმობილეს-ი	größter Anhänger
უჟამიერეს-ი	zur günstigsten Zeit
უმტერეს-ი	überaus starker Feind
მწდეთუხუცეს-ი	oberster Mundschenk
მეგანძურთუხუცეს-ი	Schatzmeister
სჳნიდის-ი	Gewissen
მთავარმამასახლის-ი	Oberabt
ტრიმის-ი	Münze (Drittel eines Aureus)
პროტარხონის-ი	großer Fürst, Großfürst
უკუნის-ი	Ewigkeit
სურწყნის-ი	Monatsname (etwa Februar); Monatsname (etwa Februar)
საჴსენოთშორის-ი	(begrabener) Toter
ეპიტირიტის-ი	Aufseher
პოტირიტის-ი	Vertreter, Stellvertreter
კოხლიოს-ი	Purpurschnecke
სხოლარიოს-ი	Leibwächter des Kaisers
ილლუსტრიოს-ი	Illustrios (byz. Titel)
სხოლასტიკოს-ი	Scholastiker
ფისკოს-ი	Fiskus, Staatsfinanzen
ტიტლოს-ი	Anordnung, Aufschrift
ნოელისიმოს-ი	Nobelissimus (byz. Titel); Nobelissimus (byz. Titel)
ეღომენოს-ი	Abt, Vorsteher
ზემოჲთგანვესკოპოს-ი	Aufseher
ებისკოპოს-ი	Bischof; Bischof
მთავარებისკოპოს-ი	Erzbischof; Erzbischof
თანაეპისკოპოს-ი	Bischofskollege
პირველეპისკოპოს-ი	Erzbischof
ხორეპისკოპოს-ი	Bischof ohne Eparchie
მაგიროს-ი	Koch
სჳნოღოროს-ი	Rechtsanwalt; Rechtsanwalt
ჳპატოს-ი	Hypatos (byz. Titel)
ფჳდერატოს-ი	Bundesgenosse, Söldner
ვიპერბერეტოს-ი	Hyperberetaios (griech. Monatsname, etwa Oktober)
ტოლონტოს-ი	Säule; Säule
აგჳსტოს-ი	August
ფილასოფოს-ი	Philosoph; Philosoph
კიმილირიხოს-ი	Schatzmeister; Schatzmeister
ეპარხოს-ი	Stellvertreter des Königs
ხარტოფილაქს-ი	Bibliothekar
ფინიქს-ი	Phönix; Phönix
პანდოქს-ი	Herbergsleiter
შთახს-ი	Myrrhe(nöl); Myrrhe(nöl)
სტახს-ი	Myrrhe(nöl)
უმთავრჱს-ი	hauptsächlich, Vorgesetzter
ტჳს-ი	dünne Saite
საბატ-ი	Sabbat
ნავატ-ი	Horn
ეპივატ-ი	Seemann
პრივატ-ი	persönliches Eigentum des Kaisers
ავდოკატ-ი	Rechtsanwalt, Advokat
ანთჳპატ-ი	Anthypatos, Stellvertreter des Hypatos (byz. Titel); Anthypatos, Stellvertreter des Hypatos (byz. Titel)
კულაპარატ-ი	Kuropalat; Kuropalat
კალაფატ-ი	Steinbrenner
ლიღატ-ი	Testament, Legat; Testament, Legat
ნახაპეტ-ი	Stammvater, Patriarch, Satrap; Stammvater, Patriarch, Satrap
სპაჲპეტ-ი	Feldherr; Feldherr
მთავარსპაჲპეტ-ი	Oberfeldherr
პალეგავტ-ი	Umhang
აფროდიტ-ი	Venus
იპიტირიტ-ი	Aufseher
პროტოასიკრიტ-ი	Kanzleivorsteher
პრეპოსიტ-ი	Amtsperson
ფაკტ-ი	geschehen, Angelegenheit, Faktum
ასპალანტ-ი	ein Gewürz
ნესუ-ხავარტ-ი	Zuckermelone
არღონაფტ-ი	Argonaut
არღუნაფტ-ი	Argonaut; Argonaut
საჲტ-ი	Krug
პანნაშჳტ-ი	Totenfeier, Totengedenken; Totenfeier, Totengedenken
ბუზუ-ი	Fliege; Fliege
ლომისლეკუ-ი	Löwenjunges
პიტუ-ი	Fichte
ფუშუ-ი	Leistenbruch
უეჭუ-ი	zweifellos, ohne Zweifel
ნაძ-ფიჭუ-ი	Fichte und Kiefer
ინჩაჴუ-ი	Kropf
ჴამლისტეფ-ი	Lederschnürsenkel
ყოვლადნაყოფ-ი	Opfer, Opfergabe
უჟამოჲსნაყოფ-ი	zur Unzeit gekommene Frucht
მთისმყოფ-ი	Gebirgsbewohner
ჳფ-ი	Maß
პატრეაქ-ი	Patriarch; Patriarch
სოფელ-ქალაქ-ი	Stadt und Land
შუვაქალაქ-ი	Stadtmitte
მზისქალაქ-ი	Heliopolis
ტუტაქ-ი	kleiner Papagei
განახეთქ-ი	Riß, Sprung, Spalt
სინოქ-ი	Gefängniszelle
კარნაჰაშ-ი	Träger eines Ehrenabzeichens
ოდიშ-ი	Westgeorgien, Mingrelien
ქსენადოშ-ი	Herberge, Gasthaus; Herberge, Gasthaus
ხორშ-ი-ხორშ-ი	von Leiste zu Leiste
პატიახშ-ი	Provinzstatthalter
ირემ-ვაც-ი	Gemse
საკაც-ი	Trage
კერძოკაც-ი	halber Mann, Eunuch
ჩოდკეც-ი	Umhang; Umhang
ტყავკეც-ი	Muschel
ჩოტკეც-ი	Umhang; Umhang
პაგურეც-ი	Apsinth
ნატკუეც-ი	Trester
მარტოსატყორც-ი	Sprungstab
ქვისსატყორც-ი	Steinschleudervorrichtung
ღორისჴორც-ი	Schweinefleisch
თანახუც-ი	Helfer des Priesters; Helfer des Priesters
ძიძ-ი	Holz(stück)
ბოლოჲთკერძ-ი	Rückseite
ურმისღერძ-ი	Radachse
შკიჭ-ი	Rosinen; Rosinen
მანიჭ-ი	Gerte, Rute
ილენჭ-ი	Falle
ნოჭ-ი	unreife Frucht, unreife Traube
კაბარჭ-ი	Köcher; Köcher
მშჳლდ-კაბარჭ-ი	Bogen und Köcher; Bogen und Köcher
თაფრუჭ-ი	Met; Met
ღჳჭ-ი	Kieselstein; Kieselstein
ანბოხ-ი	Aufruhr, Wirrwarr; Volksmenge; Aufruhr, Wirrwarr; Volksmenge
აქლემვეფხ-ი	Kamelopardalis, Antilope
პატიჯ-ი	Strafe; Strafe
საუნჯ-ი	Schatz, Besitz, Schatzkammer, Scheune
ოროჯ-ი	Lamm
ქურჯ-ი	Faust
კაჰ-ი	Geschirr
ჰურიაება-ჲ	Judentum, Jüdischwerden
ვალალაება-ჲ	Trauern, Klagen
უდბება-ჲ	Faulheit, Untauglichkeit, Bosheit, Nichtigkeit
წინამიგებება-ჲ	Empfang, Begegnung
წინამოგებება-ჲ	Treffen, Begegnung
ურგებება-ჲ	Untauglichkeit, Unbrauchbarkeit
თანამდებება-ჲ	Schuld, Verpflichtung, Pflicht
ლირბება-ჲ	Unverschämtheit
სასჯელის-გება-ჲ	Strafen, Bestrafen
სიტყჳს-გება-ჲ	Antworten, Streiten
წინადაგება-ჲ	Decken, Reichen, Opfern
მიმოქადაგება-ჲ	Verkündigen, Predigen
ჯადაგება-ჲ	Plädieren, Redekunst
სიტყჳს-მიგება-ჲ	Antworten
ნაცვლისმიგება-ჲ	Entgelten, Vergelten
სახისა განგება-ჲ	redliches Leben
წინაგანგება-ჲ	vorheriger Beschluß, vorherige Festlegung
სიტყჳს-მოგება-ჲ	Antworten
ნაცვლისმოგება-ჲ	Ersatz, Gegenleistung
ზღვის-დება-ჲ	Niederstürzen, Schadenerleiden
საზღვრის-დადება-ჲ	Grenzfestlegung
ქუედადება-ჲ	Untenhinlegen
წინაგანმზადება-ჲ	Vorbereitung
წინამომზადება-ჲ	Vorbereitung
ფერად-ფერადება-ჲ	Verschiedenartigkeit
წუადება-ჲ	Räkeln
საკჳრველთმოქმედება-ჲ	Wundertätigkeit
ქველისმოქმედება-ჲ	Barmherzigkeit
კეთილისმოქმედება-ჲ	Wohltätigkeit
სიტყჳსმოქმედება-ჲ	Dichtung, künstlerisches Werk
გარემოსქმედება-ჲ	Ringsummachen
არაწმინდება-ჲ	Unreinheit; Unreinheit
წინადაწინდება-ჲ	Verlobung
ლოდება-ჲ	Warten, Abwarten
უბადრუკ-წოდება-ჲ	Unglücklichnennen
სახელისწოდება-ჲ	Benennen
მენარდება-ჲ	Würfelspiel
ერთღმრთეება-ჲ	Einheit Gottes
მრავალღმრთეება-ჲ	Vielgötterglaube, Polytheismus
შთამოქუეება-ჲ	Herabkommen
მოკუდავება-ჲ	Sterblichkeit
კეთილადშეზავება-ჲ	Schönheit, Güte
ერთშეზავება-ჲ	Vermischtes
მენავება-ჲ	Seefahrt
ღმრთისმოსავება-ჲ	Hoffnung auf Gott
ზეაღფრინვება-ჲ	Auffliegen
თითოვება-ჲ	Besonderheit; Besonderheit
უღმთოვება-ჲ	Ungläubigkeit; Ungläubigkeit
მხოლოვება-ჲ	Alleinsein
სარწმუნოვება-ჲ	Vertrauen, Glauben; Vertrauen, Glauben
სასოვება-ჲ	Hoffnung; Hoffnung
უწესოვება-ჲ	Ungesetzlichkeit, Ungerechtigkeit; Ungesetzlichkeit, Ungerechtigkeit
სიტფოვება-ჲ	Wärme; Wärme
ცრუვება-ჲ	Lügen
წინაგანმართება-ჲ	Versuch, Fleiß
მართლწარმართება-ჲ	richtiges Wandeln
ნოტიება-ჲ	Nässe, Feuchtigkeit
სიტყჳსგამოძიება-ჲ	Wortstreit
მიმოძიება-ჲ	Suchen, Untersuchen
მოპაჰრაკება-ჲ	Nötigung, Zwang, Gewaltanwendung
ტოზიკება-ჲ	Feiern des Bußfestes
უბადრუკება-ჲ	Unglück, Armseligkeit
მომავალება-ჲ	Kommen, Kommenkönnen
ერთბრწყინვალება-ჲ	Einssein im Glanz
მბრწყინვალება-ჲ	Glanz, Glänzen
სიტყუათმბრწყინვალება-ჲ	Redekunst, Rhetorik
მსახრვალება-ჲ	Zauberei
მიმოცვალება-ჲ	Hin- und Herbiegen, Verändern
თანამიმოცვალება-ჲ	Veränderlichkeit
უკუცვალება-ჲ	Umtausch
წრტიალება-ჲ	schrecklicher Schmerz
სულმყრალება-ჲ	Gestank
მრავალმოწყალება-ჲ	große Gnade
მაბრალობლება-ჲ	Beschuldigen; Beschuldigen
მაცილობლება-ჲ	Streit, Widerspenstigkeit; Streit, Widerspenstigkeit
შემადლება-ჲ	Dankbarkeit
მაბრალებელება-ჲ	Beschuldigen
უმსახურებელება-ჲ	Ungläubigkeit
მახლობელება-ჲ	Nähe, Nahestehen
უცნობელება-ჲ	Dummheit, Unverständnis
უცოდველება-ჲ	Sündenlosigkeit, Reinheit
უზრუნველება-ჲ	Sorglosigkeit, Unbesorgtheit
წინადაუცუეთელება-ჲ	Unbeschnittenheit
ძრიელება-ჲ	Stärke, Festigkeit, Heer; Stärke, Festigkeit, Heer
უსწავლელება-ჲ	Ungebildetheit
შუამდგომელება-ჲ	Vermittlung, Versöhnung; Vermittlung, Versöhnung
უპოვნელება-ჲ	Nichtauffinden
უკუანაჲსკნელება-ჲ	Ende, Schluß
უქონელება-ჲ	Armut
უცონელება-ჲ	Fleiß
ურყუნელება-ჲ	Unverwestheit, Unvergänglichkeit
განურყუნელება-ჲ	Reinheit
უხრწნელება-ჲ	Unverdorbenheit
თანამეტყუელება-ჲ	Bestätigen, Bekräftigen
ცუდადმეტყუელება-ჲ	unsinniges Reden
მალიადმეტყუელება-ჲ	schnelles Sprechen
ტკბილადმეტყუელება-ჲ	Schmeichelei
მრავალმეტყუელება-ჲ	Geschwätz, Gerede
მართლგამომეტყუელება-ჲ	Erklärung
წინაწარმეტყუელება-ჲ	Prophezeiung
პირმეტყუელება-ჲ	Sprechen, Sprechfähigkeit
ცუდისმეტყუელება-ჲ	unsinniges Reden
მდაბლისმეტყუელება-ჲ	bescheidenes Reden
ქველისმეტყუელება-ჲ	wohlwollendes Reden, Predigen zur Güte
ძჳრისმეტყუელება-ჲ	Lästern
გულწრფელება-ჲ	Offenherzigkeit, Aufrichtigkeit
მჴევლება-ჲ	Dienst als Dienerin / Magd / Sklavin
ცხოვლება-ჲ	Leben; Leben
შეწყობილება-ჲ	Anpassung, Harmonie
მხოლოდშობილება-ჲ	Besitz nur eines Sohnes
განგრძობილება-ჲ	Fortsetzung, Verlängerung
განბჭობილება-ჲ	Urteil
ბორგილება-ჲ	Wahnsinn; Irrtum
განცდილება-ჲ	Sehen, Betrachten, Untersuchen
ვლტოლვილება-ჲ	Flucht
ოქროგანრჩულვილება-ჲ	Goldbeschlag, Goldüberzug
განკუთნვილება-ჲ	Eigenschaft
დათრგუნვილება-ჲ	Zerstampfen
დამუსრვილება-ჲ	Zerstören, Zerschlagen, Zerrütten
ჭურვილება-ჲ	Bewaffnung, Rüstung, Ausrüstung
ორგანკუეთილება-ჲ	Zweiteilen
წინადაცუეთილება-ჲ	Beschneidung
წინადაუცუეთილება-ჲ	Unbeschnittenheit
წურთილება-ჲ	Abrichten, Unterrichten
მართლწურთილება-ჲ	Wahrheitslehre
ქუედადრეკილება-ჲ	Gebeugtheit
ღრეკილება-ჲ	Gekrümmtheit, Gebeugtheit
შედგომილება-ჲ	Folgen, Begleiten
წარმოდგომილება-ჲ	Kommen, Herbringen
შთავრდომილება-ჲ	Hineinfallen
განვრდომილება-ჲ	Davonstürzen, Sichentfernen
შთამოვრდომილება-ჲ	Herabfallen
გონებაცთომილება-ჲ	Wahnsinn, Dummheit
მოცთომილება-ჲ	Fehler
შრომილება-ჲ	Arbeit, Mühe
ჴუედნილება-ჲ	Geschimpfe, Vorwurf
გარდაფენილება-ჲ	überdecken, Entfalten
პოვნილება-ჲ	Habe, Besitz
თხზნილება-ჲ	Zopf; List
უდებქმნილება-ჲ	Faulheit, Mißachtung
სულმოკლექმნილება-ჲ	Nachlassen, ängstlichsein, Enttäuschung
უსჯულოქმნილება-ჲ	Unanständigkeit, Schlechtigkeit
მოქმნილება-ჲ	Schmücken, Verzieren
წმასნილება-ჲ	Lüge, Heimtücke
დაჴსნილება-ჲ	Auflösen, Zerstören, Gelähmtwerden, Zügellosigkeit
განრყუნილება-ჲ	Verderben
განხრწნილება-ჲ	Verderben; Verderben
განჴრწნილება-ჲ	Verderben
წიგნ-წერილება-ჲ	Schreiben, Geschriebenes
განჭრილება-ჲ	Teilen, Trennen
განგლესილება-ჲ	Verputzen, Färben; Glänzen
მრავალგანყოფილება-ჲ	Trennung, Spaltung, Unterschiedlichkeit
მიმოგანყოფილება-ჲ	Getrenntheit
სათნოყოფილება-ჲ	Gefallen
ბერწყოფილება-ჲ	frühere Kinderlosigkeit / Unfruchtbarkeit
უძილება-ჲ	Wachsein
განტეხილება-ჲ	Brechen, Zerbrechen, Zerschlagen
მართლმხილება-ჲ	berechtigtes Bezichtigen, berechtigte Anschuldigung
დასჯილება-ჲ	Bestrafung
დაშჯილება-ჲ	Strafe, Bestrafung
ჴაჴილება-ჲ	Kratzen
გულისკლება-ჲ	Verdrossenheit, Kränkung
სასუმლება-ჲ	Adoption, Behandlung als Nahestehenden
თანამსრბოლება-ჲ	Mitreisen
დაბკოლება-ჲ	Irren; Stören; Verführen
დაპკოლება-ჲ	Irren; Stören; Verführen; Irren; Stören; Verführen
თანამბრძოლება-ჲ	Beistehen im Kampf
წინამბრძოლება-ჲ	Führung
მძლავრმბრძოლება-ჲ	harter Kampf
ღმრთისმბრძოლება-ჲ	Kampf gegen Gott, Häresie
სასწაულება-ჲ	Zeichen, Wunder
დაგებულება-ჲ	Machen, Bereiten, Schmücken
ქადაგებულება-ჲ	Predigt, Predigen
წინაგანგებულება-ჲ	vorheriger Beschluß, vorherige Festlegung
კეთილადგანგებულება-ჲ	gute Ordnung, gute Verwaltung
შემზადებულება-ჲ	Vorbereitung, Bereitsein, Bereithaltung
განმზადებულება-ჲ	Vorbereiung, Besitz, Schmuck; Plan
განცხადებულება-ჲ	Offenbaren, Erscheinen, Klarheit
განგდებულება-ჲ	Hinauswerfen, Entfernen
კეთილდიდებულება-ჲ	Großartigkeit
სახელდებულება-ჲ	Benennung, Namensgebung
შეცოდებულება-ჲ	Sündigkeit
დამჟავებულება-ჲ	Sauersein
განბრწყინვებულება-ჲ	Glanz
განქარვებულება-ჲ	Verstreuen, Zerstörung
შეცვალებულება-ჲ	Veränderung, Veränderlichkeit
სახისცვალებულება-ჲ	ändern, Verändern
განწვალებულება-ჲ	Teilung, Trennung
დაბნელებულება-ჲ	Finsternis, Dunkel; Sündigen
დაძუელებულება-ჲ	Altern
მხილებულება-ჲ	Aufdecken
დაკლებულება-ჲ	Verringerung, Mangel; Verdruß, Schmerz
უფლებულება-ჲ	Herrschaft, Recht
განახლებულება-ჲ	Erneuerung
ცნობავნებულება-ჲ	Verrücktheit
მრავალვნებულება-ჲ	große Not
მიმჴცოვნებულება-ჲ	Alter
მოვლინებულება-ჲ	Hersenden
გამოჩინებულება-ჲ	Erscheinen
წარჩინებულება-ჲ	Erlesenheit, Hochadel
ქორწინებულება-ჲ	Heirat
განკანონებულება-ჲ	Verurteilung; Festlegung
შჱნებულება-ჲ	Gebäude, Bauwerk
დამყარებულება-ჲ	Gründung, Festigen
მომედგრებულება-ჲ	Faulheit
მიმძლავრებულება-ჲ	Unterdrückung
შემოკრებულება-ჲ	Versammeln, Versammlung
განშორებულება-ჲ	Entfernen
მსახურებულება-ჲ	Dienst
წარმატებულება-ჲ	Erfolg
განმარტებულება-ჲ	Richtigkeit, Wahrhaftigkeit
ჴუებულება-ჲ	Fehlen, Abnehmen, Vermindern, Mangel
განკაფებულება-ჲ	Abnutzung, Verschleiß
განცოფებულება-ჲ	Torheit, Verrücktheit
განლაღებულება-ჲ	Frechheit, Dreistheit
ნათელღებულება-ჲ	Taufe
განღებულება-ჲ	Hinausschaffen; öffnen
შემტკიცებულება-ჲ	Befestigung, Verbindung, Festigkeit, Bestätigung
მომრგულება-ჲ	Rundheit
მოქადულება-ჲ	Prahlen, Drohen, Rühmen
წარწყმედულება-ჲ	Zugrundegehen, Verlieren
სყიდულება-ჲ	Kaufbrief
სდულება-ჲ	Sammeln, Ernten
თითოვეულება-ჲ	Alleinsein; Eigenschaft
ჭირვეულება-ჲ	Not, Elend, Armut
ეშმაკეულება-ჲ	Teuflischkeit, Besessenheit, Mondsüchtigkeit
მრჩობლეშმაკეულება-ჲ	große Teufelei / Heimtücke
ბრალეულება-ჲ	Vergehen, Verbrechen
სახლეულება-ჲ	Familienleben, gemeinsames Leben
მიმოდაბნეულება-ჲ	Zerstreutheit, Geistesabwesenheit
მიმოგანბნეულება-ჲ	Verstreuen
შიშნეულება-ჲ	Furchtsamkeit, Zurückhaltung
თითოეულება-ჲ	Alleinsein; Eigenschaft
განრღუეულება-ჲ	Zerrütten, Zerstören
ჰავჩუეულება-ჲ	Bosheit
შერყეულება-ჲ	Beben, Erschütterung, Absetzung
ჭურრჩეულება-ჲ	Reichtum
გარდაქცეულება-ჲ	Verführung
მროწეულება-ჲ	Herde; Vielzahl
მოხაზულება-ჲ	Zeichnung, Umriß
ოქროთხზულება-ჲ	Vergolden
შეკრძალულება-ჲ	Vorsicht, Schutz
განკრძალულება-ჲ	Vorsicht, Zurückhaltung
მოკრძალულება-ჲ	Schutz, Bedeckung
ძჳრხილულება-ჲ	Missetat, Verbrechen
თავდგმულება-ჲ	Krone
კდემულება-ჲ	Zurückhaltung, Scham
ღელვაგუემულება-ჲ	Erregung, Toben
დაცემულება-ჲ	Stürzen, Sturz, Umstürzen, Niederfallen, Sündenfall
გარდაცემულება-ჲ	Fülle
პატივცემულება-ჲ	Verehrung, Stellung, Amt
განთქუმულება-ჲ	Ruhm
სახელგანთქუმულება-ჲ	Ruhm, Berühmtheit
მიმოგანთქუმულება-ჲ	Nachrichtenverbreitung
მრავალგანთქმულება-ჲ	Berühmtheit
მორთხმულება-ჲ	Tapferkeit, Wagemut
მოსხმულება-ჲ	Pflastern
შექმნულება-ჲ	Machen, Schaffen; Werk
ღმერთქმნულება-ჲ	Gottheit, Vergöttlichung, Göttlichkeit
უდაბნოქმნულება-ჲ	Einsamkeit, Alleinsein
უჩინოქმნულება-ჲ	Vernichten, Verschwinden
უღონოქმნულება-ჲ	Not, Elend, Unvermögen
უცხოქმნულება-ჲ	Entfernen
წარპარულება-ჲ	Stehlen, Rauben
თავმოყუარულება-ჲ	Stolz
დაფარულება-ჲ	Verbergen, Geheimnis
მიფარულება-ჲ	Geheimnis
უსრულება-ჲ	Unvollkommenheit
უძრულება-ჲ	Kraftlosigkeit, Schwäche, Krankheit, Unvermögen; Kraftlosigkeit, Schwäche, Krankheit, Unvermögen
განთესულება-ჲ	Verstreuen
თანაშექუსულება-ჲ	Vereinen
ურწყულება-ჲ	Wasserlosigkeit
დაჴშულება-ჲ	Schließen
ძმათმოძულება-ჲ	Bruderhaß
კაცთმოძულება-ჲ	Menschenhaß
სიქალწულება-ჲ	Jungfräulichkeit, Jungfernschaft
თანამეუღლება-ჲ	Eheverhältnis
თანაშეუღლება-ჲ	Heiraten
ულვაშთმიახლება-ჲ	Zeit des ersten Schnurrbartwachsens
გარდასახლება-ჲ	Umsiedeln
მოსისხლება-ჲ	Blutbesudeln
სახელისმოდგამება-ჲ	Namensvetternschaft
ცრუჲს-წამება-ჲ	Verleumdung
ცილისშეწამება-ჲ	Verleumdung
მოწამება-ჲ	Zeugnis, Martyrium
თანამოწამება-ჲ	Bezeugen
ძჳრისწამება-ჲ	Verklagen wegen einer Missetat
ცრუწამება-ჲ	falsches Zeugnis
სახისჩემება-ჲ	Heucheln, Betrügen, Vortäuschen
უზმება-ჲ	Hungern
შემდგომითი შემდგომება-ჲ	Folge, Abfolge, Reihenfolge
ტომება-ჲ	Verwandtschaft
წერით მოსაქმება-ჲ	Schreiben, Abschreiben
ქრისტეანება-ჲ	Christentum
მწინკულევანება-ჲ	Schmutzigkeit
სახარულევანება-ჲ	Freude
მხივანება-ჲ	Eiter
ცმელოვანება-ჲ	Fettigkeit
ძნელოვანება-ჲ	Not, Schwierigkeit
ჯეროვანება-ჲ	Ordentlichkeit, Anständigkeit
ნათელცისკროვანება-ჲ	Hervorleuchten
ყვანება-ჲ	Wegbringen, Fortbringen
თანაყვანება-ჲ	Hinführen, Hinbringen
თანამიყვანება-ჲ	Hinführen, Hinbringen
უკუნყვანება-ჲ	Zurückholen, Zurückschicken
თანააღმოყვანება-ჲ	Heraufholen
ზნოანება-ჲ	Bosheit, Schlechtigkeit
რაოდენება-ჲ	Maß, Menge, Anzahl
ძჳრისმოჴსენება-ჲ	Nachtragen, Nachtragendsein
ძჳრისჴსენება-ჲ	Nachtragen, Unfähigkeit zu Verzeihen
მოგზავნება-ჲ	Kommen
აღზუავნება-ჲ	Hochmut / Stolz; Hochmut / Stolz
წარდევნება-ჲ	Vertreiben, Verjagen
ჰასაკოვნება-ჲ	Größe
სიტყუაჴელოვნება-ჲ	bildhaftes Reden
ცუდჴელოვნება-ჲ	Vergeblichkeit
ჰავჴელოვნება-ჲ	Schlechtigkeit, Bosheit, Bösartigkeit
მწუანვილოვნება-ჲ	Kräuterich
მარილოვნება-ჲ	Salzigkeit
თესლოვნება-ჲ	Samen
გუამოვნება-ჲ	Fleischlichkeit
სამგუამოვნება-ჲ	Dreifaltigkeit, Dreieinigkeit
ჰამოვნება-ჲ	Angenehmheit
ვნებულგემოვნება-ჲ	Unersättlichkeit
ნიშნოვნება-ჲ	Zeichen
მოპოვნება-ჲ	Finden, Gewinnen, Erwerben
ღჳრღუაროვნება-ჲ	Unwegsamkeit
სამხატოვნება-ჲ	Dreigestaltigkeit
მარგალიტოვნება-ჲ	Glanz
სახოვნება-ჲ	Schönheit
თავმოთნება-ჲ	Selbstgefälligkeit, Stolz
კაცთმოთნება-ჲ	Schmeichelei, Gefallen
თავსმოთნება-ჲ	Selbstgefälligkeit, Stolz; Selbstgefälligkeit, Stolz
პირთნება-ჲ	Schmeicheln
კუალს-დგინება-ჲ	Belehren
სასყიდლითდადგინება-ჲ	Einstellen, Dingen
შედგინება-ჲ	Hineinstellen
გულსმოდგინება-ჲ	Fleiß, Streben
წინააღდგინება-ჲ	Gegenüberstellen, Hinstellen
წუადინება-ჲ	Räkeln
წარმოდინება-ჲ	Herbeifließen
აღმოდინება-ჲ	Herausfließen
მოსმინება-ჲ	Hörenlassen
ზედგამოჩინება-ჲ	Erscheinen
მრავალნება-ჲ	unterschiedlichen Willens
ზმნება-ჲ	Erfahren, Erkennen, Vorhersehen, Denken, Beabsichtigen
მოლაზონება-ჲ	Mönchsein, Nonnesein, Mönchwerden, Nonnewerden; Mönchsein, Nonnesein,
დიაკონება-ჲ	Dienst als Diakon
თანამონება-ჲ	gemeinsamer Dienst
მრავალღონება-ჲ	große List, Hinterlist
მოღონება-ჲ	Zustandebringen, Bewerkstelligen
ყუავილოსნება-ჲ	Blüte, Schönheit
გჳრგჳნოსნება-ჲ	Gekröntsein
შემონაზუნება-ჲ	Mönchwerden
რცხჳნება-ჲ	Beschämen, Scham
შერცხჳნება-ჲ	Scham, Schämen, Beschämung
უცნობოება-ჲ	Unverständnis, Dummheit
ურიდოება-ჲ	Unverschämtheit
უთავოება-ჲ	Führungslosigkeit
უპატივოება-ჲ	Mißachtung
უნივთოება-ჲ	Immaterialität
უღმთოება-ჲ	Ungläubigkeit; Ungläubigkeit
უძალოება-ჲ	Kraftlosigkeit
მესაიდუმლოება-ჲ	Geheimnislösen
უკრძალულოება-ჲ	Dreistigkeit, Ungeniertheit
უნაკლულოება-ჲ	Vollständigkeit
უსრულოება-ჲ	Unvollkommenheit; Unvollkommenheit
ურჩულოება-ჲ	Gesetzeswidrigkeit, Ungerechtigkeit, Missetat
უსისხლოება-ჲ	unblutiges Opfer
უსირცხჳლოება-ჲ	Unverschämtheit
დაუსაბამოება-ჲ	Anfangslosigkeit
თანადაუსაბამოება-ჲ	Anfangslosigkeit, Ewigkeit
უჟამოება-ჲ	Unzeitigkeit, Ungelegenheit
უგუამოება-ჲ	Immaterialität
უზომოება-ჲ	Maßlosigkeit
უდაბნოება-ჲ	Einöde, unbesiedelte Gegend
მეუდაბნოება-ჲ	Eremitenleben
ყოვლადსათნოება-ჲ	übergroße Barmherzigkeit
საჩინოება-ჲ	Klarheit, Deutlichkeit; Art
უჩინოება-ჲ	Unsichtbarkeit, Verborgenheit
უქონოება-ჲ	Armut
უოხჭნოება-ჲ	Unvollendetheit
მდიდროება-ჲ	Reichtum
უმთავროება-ჲ	Führerlosigkeit
უმშჯავროება-ჲ	Ungerechtigkeit; Ungerechtigkeit
წჳმროება-ჲ	Regenzeit
მრავალწჳმროება-ჲ	Regenzeit
მწჳმროება-ჲ	Regenwetter, Regenzeit
მცირედმწჳმროება-ჲ	Trockenheit, Dürre
უსწოროება-ჲ	Ungleichheit
ძელითხუროება-ჲ	Tischlerarbeit, Zimmermannsarbeit
სიტფოება-ჲ	Wärme; Wärme
უშიშოება-ჲ	Furchtlosigkeit; Furchtlosigkeit
უჴორცოება-ჲ	Körperlosigkeit
უსახოება-ჲ	Böses, Bosheit; Böses, Bosheit
მდებარება-ჲ	Liegen, Lage, Sein
მგზებარება-ჲ	Anzünden, Brennen
მძიმედმხედვარება-ჲ	schlechtes Sehen
მგლინვარება-ჲ	Glätte
მგლოვარება-ჲ	Trauer
მწოვარება-ჲ	Saugen, Säugen
თანაზიარება-ჲ	Teilnahme, Einheit
მწოლარება-ჲ	Liegen
მძრწოლარება-ჲ	Furcht, Zittern
მდგომარება-ჲ	Sein, Stehen, Lage
მართლმდგომარება-ჲ	Richtigkeit, Wahrheit
მკრთომარება-ჲ	Herausschimmern
მცენარება-ჲ	Pflanzentum
ნაყოფთმცენარება-ჲ	Fruchtbarkeit
მოცინარება-ჲ	Lachen
უცხოთშეწყნარება-ჲ	Aufnahme von Fremden
უპოარება-ჲ	Armut; Armut
მართლაღსარება-ჲ	Orthodoxie
ძმათმოყუარება-ჲ	Bruderliebe, Nächstenliebe
ნოვაგთმოყუარება-ჲ	Eßlust
ტკივილთმოყუარება-ჲ	Mitgefühl, Streben
შვილთმოყუარება-ჲ	Kinderliebe
უცხოთმოყუარება-ჲ	Gastfreundlichkeit
სტუმართმოყუარება-ჲ	Gastfreundschaft
საჴმართმოყუარება-ჲ	Eigennutz
თჳსთმოყუარება-ჲ	Nächstenliebe
ვნებულმოყუარება-ჲ	Lüsternheit
დიდებისმოყუარება-ჲ	Ruhmsucht
ცილობისმოყუარება-ჲ	Streitsucht
მტერობისმოყუარება-ჲ	Feindschaftsliebe, Streitsucht
მთავრობისმოყუარება-ჲ	Machthunger, Karrieretum
თხრობისმოყუარება-ჲ	Erzählfreude
თავისმოყუარება-ჲ	Ehrliebe, Ehrgeiz
ძლევისმოყუარება-ჲ	Siegesgewohnheit, Stolz
პატივისმოყუარება-ჲ	Ehrgeiz
ღმრთისმოყუარება-ჲ	Liebe zu Gott, Frömmigkeit
ვეცხლისმოყუარება-ჲ	Liebe zum Geld
ვერცხლისმოყუარება-ჲ	Liebe zum Geld; Liebe zum Geld
შრომისმოყუარება-ჲ	Arbeitsliebe
სიბრძნისმოყუარება-ჲ	Philosophie
სტუმრისმოყუარება-ჲ	Gastfreundschaft
ოქროჲსმოყუარება-ჲ	Goldliebhaberei, Goldgier
მზუაობრება-ჲ	Hochmut
ცუდადმზუაობრება-ჲ	Hochmut, Stolz
ფიცხელმკელობრება-ჲ	starkes Hinken
ღმრთის-კადრება-ჲ	Widerstand / Unbotmäßigkeit gegenüber Gott
უმკჳდრება-ჲ	Unbesiedeltheit, Erbenlosigkeit
ნათიერება-ჲ	Leuchten, Licht
წყლითმანკიერება-ჲ	Wassersucht
ცოლიერება-ჲ	Beweibtsein
ჴმაშუენიერება-ჲ	angenehmer Klang
ფერშუენიერება-ჲ	Schönheit, Schönfarbigkeit
სიტყუაპოვნიერება-ჲ	Schlagfertigkeit
ქონიერება-ჲ	Besitz, Habe, Reichtum
წინაჲთმეცნიერება-ჲ	Vorauserkennen
მართლმეცნიერება-ჲ	richtiges Wissen, Wahrheit, Weisheit
ღმრთისმეცნიერება-ჲ	Gotterkennen, Theologie
პოხნიერება-ჲ	Fettheit, Reichtum; Fettheit, Reichtum
ხატიერება-ჲ	Gesicht, Darstellung
მშიერება-ჲ	Hunger
მრავალფერება-ჲ	Vielfalt
უპოვრება-ჲ	Armut
წინაგანსაზღვრება-ჲ	Festlegung
ხილისმოკრება-ჲ	Obsternte, Herbst
უწჳმრება-ჲ	Regenlosigkeit, Dürre
ნესტორება-ჲ	Nestorianertum
მოგზაურება-ჲ	Reise
საცნაურება-ჲ	Klarheit, Zeichen
უცნაურება-ჲ	Unverständlichkeit, Unbegreiflichkeit
უსუსურება-ჲ	Kraftlosigkeit, Schwäche
სიჩქურება-ჲ	Verübung einer Dummheit; Dummheit
მენავეთმოძღურება-ჲ	Schiffsführung
მღდელთმოძღურება-ჲ	Bischofsamt, Katholikosamt
კეთილადმსახურება-ჲ	Tiefgläubigkeit
მრავალთმსახურება-ჲ	Dienst an vielen Göttern
მრავალმსახურება-ჲ	großer Dienst, Fleiß
ქრისტესმსახურება-ჲ	Christusverehrung
ღმრთისმსახურება-ჲ	Gläubigkeit
ცეცხლისმსახურება-ჲ	Feueranbeterei, Mazdaismus
ანგაჰრება-ჲ	Gier, Habgier
ღმრთისმსგავსება-ჲ	Gottnacheifern
მთავარეპისკოპოსება-ჲ	Amt des Erzbischofs
სამწმიდაარსება-ჲ	Dreifaltigkeit
მოყუსება-ჲ	Freundschaft
თჳს-თჳსება-ჲ	Eigenschaft
უცხოხატება-ჲ	Außergewöhnlichkeit
მრავალბოროტება-ჲ	vielfältige Bosheit
თანაშეტყუება-ჲ	Entsprechen, Anpassen
პირუტყუება-ჲ	Nichtsprechenkönnen
საეჭუება-ჲ	Zweifelhaftigkeit
რეხუება-ჲ	Trampeln, Klopfen
ურიცხუება-ჲ	Unzähligkeit
უმარჯუება-ჲ	Ungeschicklichkeit
ცუდადმოსწრაფება-ჲ	vergebene Arbeit / Mühe
თჳთჴელმწიფება-ჲ	Freiheit
თანამყოფება-ჲ	Zusammenleben, Unterstützen
მოქალაქება-ჲ	Wirken
თანამიღება-ჲ	Mitnehmen
საზრდელთმიღება-ჲ	Essen
უკუნღება-ჲ	Zurücknahme
მიზეზისა მოღება-ჲ	Vorwand, Vorschützen
მიცემა-მოღება-ჲ	Austausch, Tausch
თესლის-გამოღება-ჲ	Samenausbildung
სახისშემოღება-ჲ	Anführen eines Beispiels
მიმოღება-ჲ	Her- und Fortbringen
აღმოდუღება-ჲ	Sprießen, Emporwachsen
გულისწყება-ჲ	Erzürnen
უშიშება-ჲ	Furchtlosigkeit
დედაკაცება-ჲ	Frauentum, Weiblichkeit, Fraulichkeit
ერისკაცება-ჲ	Bürgertum, Soldatentum, Dienst bei einem weltlichen Herrn
მძლავრწარტაცება-ჲ	gewaltsame Entführung
თანააღტაცება-ჲ	Begeisterung
ზედადამტკიცება-ჲ	Bestätigung
ცრუფიცება-ჲ	Schwören eines Meineids
შეტყორცება-ჲ	Werfen, Schießen, Hineinwerfen
თანამოღუაწება-ჲ	Unterstützen, Beistand im Kampf
ანბა-ჲ	geistlicher Vater, Mönch, Priester, Abt; geistlicher Vater, Mönch, Priester, Abt
ფრთხილბუნებაობა-ჲ	Wachsamkeit, Vorsicht
ზედაჲსზედაობა-ჲ	Häufigkeit
საყოველთაობა-ჲ	öffentlichkeit, Allgemeinheit
მჴნისთაობა-ჲ	Vorsitz am Tisch
ჰურიაობა-ჲ	Judentum, Jüdischwerden; Judentum, Jüdischwerden
ნოტიაობა-ჲ	Nässe, Feuchtigkeit
კალაობა-ჲ	Zinnhaltigkeit
უხილაობა-ჲ	Unsichtbarkeit; Unsichtbarkeit
თჳთკმაობა-ჲ	Genügsamkeit
ორჴმაობა-ჲ	Meinungsverschiedenheit
მფრთუანაობა-ჲ	Bezaubern
სხუაენაობა-ჲ	Fremdsprachigkeit
სეხნაობა-ჲ	Wesens- Namensgleichheit
მდრტჳნაობა-ჲ	Unzufriedenheit, Erregung, Murren
უწირაობა-ჲ	Nichtopferbereitschaft
დაუბურაობა-ჲ	Ungedecktheit, Dachlosigkeit
მესუხრაობა-ჲ	Fronarbeit
თანამონათესაობა-ჲ	Landsmannstum; Landsmannstum
სხჳსაობა-ჲ	fremdes Eigentum
ზეშთასიტყუაობა-ჲ	Vielrednerei, Schwätzerei
უქმსიტყუაობა-ჲ	sinnloses Gerede, Geschwätz
პატიოსანსიტყუაობა-ჲ	ehrenhaftes Erwähnen, Verherrlichen
კნინსიტყუაობა-ჲ	Wortkargheit
გულისსიტყუაობა-ჲ	überlegung, Absicht
ლიქნისსიტყუაობა-ჲ	Schmeichelei
თუალთუხუაობა-ჲ	Objektivität, Gerechtigkeit
მოფქაობა-ჲ	Mahlen
მსიძაობა-ჲ	Hurerei; Hurerei
მომზრახაობა-ჲ	Reden, Sprechen
მონაგებობა-ჲ	Erwerben, Besitz
უმონაგებობა-ჲ	Armut, Besitzlosigkeit
თავსმდებობა-ჲ	Aufsichnehmen; Aufsichnehmen
უზავებობა-ჲ	Ungleichheit, ungleiche Besitzverhältnisse, Unversöhnlichkeit
ერთნებობა-ჲ	Einmütigkeit; Einmütigkeit
უგონებობა-ჲ	Dummheit
მწყურნებობა-ჲ	Hochwasser, Wasserreichtum
ნასნებობა-ჲ	Rekonvaleszenz, Befinden nach überstehen einer Krankheit
ლირბობა-ჲ	Unverschämtheit
მიმაეგობა-ჲ	Handel
სჳრინგობა-ჲ	eitriges Geschwür
ნერგობა-ჲ	Setzling
თანანერგობა-ჲ	Verwandtschaft
განქარვებადობა-ჲ	Zerstörbarkeit
ნათლისღებადობა-ჲ	Taufen
ცნობადობა-ჲ	Erkennbarkeit, Erkenntnis
ზოგადობა-ჲ	Versammlung, Menge, Einheit
მალიადობა-ჲ	Schnelligkeit
კუალადობა-ჲ	Wiederholung
უჭმადობა-ჲ	Nichtessenkönnen
სათანადობა-ჲ	Notwendigkeit
მოწევნადობა-ჲ	Kommen, Begegnen, Erreichen, Widerfahren
დაჴსნადობა-ჲ	Auflösung
განხრწნადობა-ჲ	Verderben
თითოჲსჯერადობა-ჲ	Ersatz, Ersetzen
ყოფადობა-ჲ	Sein, Existenz
თანამოქმედობა-ჲ	Mitarbeit; Mitarbeit
შფოთისმოქმედობა-ჲ	Aufstand, Aufruhr, Streit
ქუეყანისმოქმედობა-ჲ	Bodenbearbeitung
მებრძმედობა-ჲ	Schmelzen
მეორედობა-ჲ	Reihenfolge
სიტყუადიდობა-ჲ	Großtun, Prahlen
ნიჭდიდობა-ჲ	überfluß, Fülle
ურიდობა-ჲ	Unverschämtheit; Unverschämtheit
ჴელურიდობა-ჲ	Unverschämtheit, Grobheit
შარავანდობა-ჲ	Königtum
წინდობა-ჲ	Verlobung
წელიწდობა-ჲ	Jahr, Alter
მრავალსანოაგეობა-ჲ	Unersättlichkeit
მეჭადრაგეობა-ჲ	Schachspiel
განმგეობა-ჲ	Leiten, Führen
წყლტუკლდეობა-ჲ	glatter Fels
მწუხრამდეობა-ჲ	Vorabendzeit
მიმლოდეობა-ჲ	Warten
მენარდეობა-ჲ	Würfelspiel
მითვეობა-ჲ	Gleichheit
მოჰარშივეობა-ჲ	Erwerben, Sichaneignen
ნამდჳლვეობა-ჲ	Wahrheit
თანამეარვეობა-ჲ	Zusammensein
თანამოკარვეობა-ჲ	Zusammensein
თანამონათესვეობა-ჲ	Landsmannstum
უსიკეთეობა-ჲ	Bosheit, Böses
მებარბითეობა-ჲ	Harfenspiel
მეშფოთეობა-ჲ	Aufruhr, Empörung
მოსენაკეობა-ჲ	Einsiedelei, Mönchsdasein
მეპრატაკეობა-ჲ	Lederbearbeitung
მეჯაუკეობა-ჲ	Verschwörung
მაკაბალეობა-ჲ	Streitbeilegung, Versöhnung, Verständigung
მომთრვალეობა-ჲ	Trunkenheit, Säuferei
მენაცვალეობა-ჲ	Ersetzen, Erben
მონაცვალეობა-ჲ	Wechseln, ändern, Veränderlichkeit; Erbe
მოსახელეობა-ჲ	Namensgleichheit
თანამოსახელეობა-ჲ	Namensvetternschaft
მესაშუვლეობა-ჲ	Mittelstellung
მოვაქილეობა-ჲ	Rechtsanwaltsamt
მეწამლეობა-ჲ	Zauberei, Arzneibereitung
მემსხუერპლეობა-ჲ	Opfern
მღდელთმემსხუერპლეობა-ჲ	Gottesdienst
მემამულეობა-ჲ	Herkunft aus demselben Land; Erbe, Erbschaft
მოძულეობა-ჲ	Haß; Haß
ბოროტისმოძულეობა-ჲ	Haß / Abneigung gegen das Böse
უმეუღლეობა-ჲ	Gattenlosigkeit
თანამოსარჩლეობა-ჲ	Unterstützung
მეღუაწლეობა-ჲ	Arbeiten, Kämpfen
ტჳრთმძიმეობა-ჲ	Heben / Ertragen einer schweren Last
თანამოლმეობა-ჲ	Mitgefühl
მწუანეობა-ჲ	Grün
მრისხანეობა-ჲ	Zorn, Wut; Zorn, Wut
არამოჴსენეობა-ჲ	Vergessenheit, Vergessen
ძჳრისმოჴსენეობა-ჲ	Nachtragen, Nachtragendsein; Nachtragen, Nachtragendsein
მარჯუენეობა-ჲ	Wahrheit
მრავალმოქენეობა-ჲ	inniges Flehen
მარცხენეობა-ჲ	Linkssein; Heimtücke
კაცთმოთნეობა-ჲ	Schmeichelei, Gefallen; Schmeichelei, Gefallen
ღჳნისმნეობა-ჲ	Amt des Oberkellermeisters
მოსურნეობა-ჲ	Wunsch
მემისნეობა-ჲ	Hellseherei
საუკუნეობა-ჲ	ewiges Leben, Ewigkeit
მართლმორწმუნეობა-ჲ	Orthodoxie
მეკერპეობა-ჲ	Götzendienerei
ზედამდებარეობა-ჲ	Obenauflegen, Darauflegen
წინამდებარეობა-ჲ	Vornliegen, Künftigkeit
მგზებარეობა-ჲ	Anzünden, Brennen; Anzünden, Brennen
ცეცხლმგზებარეობა-ჲ	Feuerfangen
დამომწთოლვარეობა-ჲ	Herabtropfen
მჭმუნვარეობა-ჲ	Trübsinn, Kummer, Traurigkeit; Trübsinn, Kummer, Traurigkeit
მლოცვარეობა-ჲ	Fliehen, Flucht
მგლოიარეობა-ჲ	Trauer
მწოლარეობა-ჲ	Liegen; Liegen
მღიმარეობა-ჲ	Lächeln
თანამდგომარეობა-ჲ	Hilfe, Zusammensein
წინაშემდგომარეობა-ჲ	Vorstehen
მართლმდგომარეობა-ჲ	Richtigkeit, Wahrheit; Richtigkeit, Wahrheit
მსხდომარეობა-ჲ	Sitzen
მჯდომარეობა-ჲ	Sitzen
ზედამჯდომარეობა-ჲ	Obensitzen, Vornsitzen
წინამჯდომარეობა-ჲ	Führung, Vorsitz
პირველმჯდომარეობა-ჲ	Leiten, Leitung
მდუმარეობა-ჲ	Schweigen
თჳთმცენარეობა-ჲ	Selbstherausfließen (des Wassers)
მძინარეობა-ჲ	Schlafen; Schlafen
მოყუარეობა-ჲ	Liebe
ცხორებისმოყუარეობა-ჲ	Lebensliebe
უპირატესობისმოყუარეობა-ჲ	Führungssucht
ძლევისმოყუარეობა-ჲ	Siegesgewohnheit, Stolz; Siegesgewohnheit, Stolz
მღჳძარეობა-ჲ	Wachheit, Wachsein; Wachheit, Wachsein
ადრეობა-ჲ	Schnelligkeit
მოსაყდრეობა-ჲ	hohes Kirchenamt
წინამოსაყდრეობა-ჲ	Vorherrschaft, Führung
მეზუერეობა-ჲ	Zolldienst
ქუემეთრეობა-ჲ	Verworfenheit
მენადირეობა-ჲ	Jagd
მეორეობა-ჲ	Reihenfolge
მეპურეობა-ჲ	Backen
მესუხრეობა-ჲ	Fronarbeit; Fronarbeit
გულსავსეობა-ჲ	Glauben, Güte; Glauben, Güte
მჭირსეობა-ჲ	Mühe, Not
მესუეტეობა-ჲ	Aufdiesäulestellen
მტეობა-ჲ	Sein, Ort
პურისმტეობა-ჲ	gemeinsames Essen
განტეობა-ჲ	Weglassen, Freilassen
მებრუეობა-ჲ	Schwindelgefühl
მენესტუეობა-ჲ	Blasinstrumentenspiel
მორცხუეობა-ჲ	Schüchternheit
მარჯუეობა-ჲ	Bewerkstelligen, Güte, Tüchtigkeit
დღითიდღეობა-ჲ	Ständigkeit
მემრუშეობა-ჲ	Hurengängerei, Ehebruch
მეკეცეობა-ჲ	Töpferei
მტკიცეობა-ჲ	Festigkeit, Stärke
ძირმტკიცეობა-ჲ	Festigkeit
მრჩობლმონაქცეობა-ჲ	Verdoppelung, Wiederholung
მიმომქცეობა-ჲ	Schwanken, Umhergehen; Schwanken, Umhergehen
მოქცეობა-ჲ	Kunstgriff, List; Tonart
მრჩობლმოქცეობა-ჲ	Wiederholung
მამაძეობა-ჲ	Verhältnis zwischen Vater und Kindern
მეანდერძეობა-ჲ	testamentarische Vererbung
მსწრაფლშემწეობა-ჲ	schnelle Hilfe
ძალმწეობა-ჲ	Hilfe
მეხარჭეობა-ჲ	Haltung einer Geliebten
სახიერებისსახეობა-ჲ	Güte
ელვისსახეობა-ჲ	Blitzen, Glänzen
ლომისსახეობა-ჲ	Löwenhaftigkeit
უსახეობა-ჲ	Böses, Bosheit
მიმოდამთხეობა-ჲ	Umherstreuen, Verstreuen
ჰეობა-ჲ	Bestätigung
პირველმესაინაჴეობა-ჲ	Vorsitzen
პირველსაინაჴეობა-ჲ	Vorsitzen
მეინაჴეობა-ჲ	Tischgenossenschaft, Tischrunde, Tafel
მგრძნებავობა-ჲ	Zauberei
სახედავობა-ჲ	Anblick, Vorstellung
მრავალთავობა-ჲ	Vielführerschaft
თთჳსთავობა-ჲ	Monatsanfang
უხილავობა-ჲ	Unsichtbarkeit; Unsichtbarkeit
მიმოწლონავობა-ჲ	Umherlungern
მფრტჳნავობა-ჲ	Dreistheit
უზოპავობა-ჲ	Wahrhaftigheit
მოძრავობა-ჲ	Bewegung
თჳთმოძრავობა-ჲ	Weitergabe (des Besitzes)
ნათესავობა-ჲ	Verwandtschaft, Volk, Generation, Art; Verwandtschaft, Volk, Generation, Art
კეთილადმოსავობა-ჲ	große Hoffnung
თუალუხუავობა-ჲ	Unvoreingenommenheit
მსიძავობა-ჲ	Hurerei
მიმომქცევობა-ჲ	Schwanken, Umhergehen
მოქცევობა-ჲ	Kunstgriff, List; Tonart
მრავალმოქცევობა-ჲ	Dauer, lange Zeitdauer
ერისთვობა-ჲ	Heerführerschaft
ციხისთვობა-ჲ	Amt des Burghauptmanns
ლომებრივობა-ჲ	Löwenhaftigkeit
კაცობრივობა-ჲ	Menschenähnlichkeit
ერთპატივობა-ჲ	gleiche Stellung
სწორპატივობა-ჲ	Ehrgleichheit, Würdengleichheit
ჰავნათესვობა-ჲ	schlechte Abstammung
ძჳრნათესვობა-ჲ	Verbrechernachkommenschaft
მეთევზობა-ჲ	Fischerei
კათალიკოზობა-ჲ	Amt des Katholikos
ბარბაროზობა-ჲ	Fremdländischkeit
გალატოზობა-ჲ	Maurerhandwerk
ანდერზობა-ჲ	Berechnen, Aufzählen, Zählen; Berechnen, Aufzählen, Zählen
უნებლიეთობა-ჲ	Unwillkürlichkeit
ეგრეთობა-ჲ	solche Art
გამომეძიებლობითობა-ჲ	Untersuchung
მზიარებელობითობა-ჲ	Teilnahme am hl. Abendmahl
მხედველობითობა-ჲ	Sichtbarkeit
ვარსკულავთმსწავლელობითობა-ჲ	Astrologie
იგავითობა-ჲ	Angleichung
გამოწულილვითობა-ჲ	genaue Untersuchung
მარჯუენითობა-ჲ	Rechtssein, Wahrheit
მიწევნითობა-ჲ	Verständnis
ზედამიწევნითობა-ჲ	Wahrheit
ნებსითობა-ჲ	Freiwilligkeit
ნეფსითობა-ჲ	Freiwilligkeit; Freiwilligkeit
შფოთობა-ჲ	Aufruhr, Streit
წუთერთობა-ჲ	Vergänglichkeit
სხუაღმრთობა-ჲ	Glaube an einen anderen Gott
შთაშთობა-ჲ	Ertränken, Ertrinken
იშჳთობა-ჲ	Seltenheit
სოფლიობა-ჲ	Weltlichkeit
ღმრთეებრიობა-ჲ	Gläubigkeit
აჩრდილებრიობა-ჲ	Schattenhaftigkeit
ცეცხლებრიობა-ჲ	Feuergleichheit, Feuerartigkeit
მთავრებრიობა-ჲ	Fürstlichkeit, Herrschaft
მჴეცებრიობა-ჲ	Wildheit, Grausamkeit
მამობრიობა-ჲ	Väterlichkeit, Amt des Abts
კჳრიობა-ჲ	Woche, Sonntag; Woche, Sonntag
ეკკლესიობა-ჲ	Versammlung, Versammeln
სწორპატიობა-ჲ	Ehrgleichheit, Würdengleichheit; Ehrgleichheit, Würdengleichheit
უვაკობა-ჲ	Unebenheit, Hinterlist
პაჰრაკობა-ჲ	Beschützen, Bewachen
უჰასაკობა-ჲ	Minderjährigkeit
სპეტაკობა-ჲ	Weiß
არქიმანდრიკობა-ჲ	Führung eines Klosters
ხარკობა-ჲ	Bezahlung, Dienst, Mühe, Arbeit, Fron, Fürsorge
მავალობა-ჲ	Gehen, Laufen
თანამავალობა-ჲ	Begleiten, gemeinsame Reise
შუამავალობა-ჲ	Vermittlung, Botengang
შემავალობა-ჲ	Hineingehen
მიმავალობა-ჲ	Hingehen, Hinlaufen
მართლმავალობა-ჲ	richtiges Gehen, Nichtfehlgehen
მომავალობა-ჲ	Kommen, Kommenkönnen; Kommen, Kommenkönnen
წინაგამომავალობა-ჲ	erster Rang
შთამომავალობა-ჲ	Nachkommenschaft
თანაშთამომავალობა-ჲ	Fürsorge, Güte
შემომავალობა-ჲ	Hereinkommen
თანაწარმავალობა-ჲ	Vorbeigehen
მსწრაფლწარმავალობა-ჲ	rasches Weggehen, Verschwinden
მიმოვალობა-ჲ	Hin- und Herlaufen
მკერვალობა-ჲ	Nähen, Schneidern
მწუერვალობა-ჲ	Höhe, Größe
მომთრვალობა-ჲ	Trunkenheit, Säuferei; Trunkenheit, Säuferei
მჴურვალობა-ჲ	Hitze, Glut, Fieberhitze, Jähzorn, Strebsamkeit
მსახრვალობა-ჲ	Zauberei; Zauberei
წარუვალობა-ჲ	Ewigkeit, Unvergänglichkeit
საშუვალობა-ჲ	Mittelposition
თანამზრახვალობა-ჲ	Einmütigkeit
მრეკალობა-ჲ	Klopfen, Hinaustreiben
მბრდღუენალობა-ჲ	Zürnen
მომღერალობა-ჲ	Spielen, Singen
მომზირალობა-ჲ	Auflauern, Beobachten
მტირალობა-ჲ	Weinen
მყრალობა-ჲ	Gestank
გულმწყრალობა-ჲ	Zürnen, Zorn
მრავალთუალობა-ჲ	Aufmerksamkeit
ღმრთისმქადაგებლობა-ჲ	Gottpredigen
მრავალწარსაგებლობა-ჲ	große Ausgabe
სიტყუათმგებლობა-ჲ	Antwort, Rechtfertigung
დაუცადებლობა-ჲ	Ununterbrochenheit; Ununterbrochenheit
მადიდებლობა-ჲ	Verherrlichung, Hochmut
საქმისდამდებლობა-ჲ	Beginn einer Angelegenheit
საზღვრისმდებლობა-ჲ	Grenzfestlegung, Anordnung
მამშჳდებლობა-ჲ	Beruhigung
დამტევებლობა-ჲ	Verlassen, Zurücklassen; Verlassen, Zurücklassen
მეძიებლობა-ჲ	Suchen
შეუცვალებლობა-ჲ	Unveränderlichkeit, Festigkeit; Unveränderlichkeit, Festigkeit
საძაგელებლობა-ჲ	Abscheulichkeit; Abscheulichkeit
შეუცილებლობა-ჲ	Unstrittigkeit
საქმისშემძლებლობა-ჲ	Fähigkeit zur Erledigung einer Arbeit
ცილისმწამებლობა-ჲ	Verleumdung; Verleumdung
შეუყვანებლობა-ჲ	Nichthineinlassen
განსასუენებლობა-ჲ	Bewirtung, Erholung
თუალმაჩუენებლობა-ჲ	Sichverstellen
მაშენებლობა-ჲ	Bauen
წინააღმომაცენებლობა-ჲ	Geburt, Zeugung
თანამთნებლობა-ჲ	Gefallen
სხუამთნებლობა-ჲ	Fremdenfreundlichkeit
მაგინებლობა-ჲ	Schimpfen; Schimpfen
შეუგინებლობა-ჲ	Reinheit, Makellosigkeit
მოუწყინებლობა-ჲ	Unermüdlichkeit
განმჩინებლობა-ჲ	Festsetzen, Festlegen; Urteilsverkündung
განუჩინებლობა-ჲ	Nichtfestlegung
საძაგელისშემძინებლობა-ჲ	übermäßige Gier
განმგონებლობა-ჲ	Verstehen, Gehorchen
უკანონებლობა-ჲ	Straflosigkeit
უქონებლობა-ჲ	Armut, Besitzlosigkeit
მაცთუნებლობა-ჲ	Verführung; Verführung
აღმსაარებლობა-ჲ	Bekenntnis, Gelübde
განმამწარებლობა-ჲ	Belästigung; Belästigung
დაუბერებლობა-ჲ	Nichtaltern
უჯერებლობა-ჲ	Ungehorsam
უსწორებლობა-ჲ	Ungleichheit
თანამცხორებლობა-ჲ	Zusammenleben, Beischlaf
მბოროტებლობა-ჲ	Bösartigkeit, Bosheit
მისაღებლობა-ჲ	Annehmen, Wegnehmen
შემომღებლობა-ჲ	Hereinschaffen
შემამტკიცებლობა-ჲ	Bestätigung, Bekräftigung, Vereinigung
უმტკიცებლობა-ჲ	Unbeständigkeit
უზუაობლობა-ჲ	Bescheidenheit
შეუწყობლობა-ჲ	Unangemessenheit
უშობლობა-ჲ	Ungeborensein; Ungeborensein
მრჩობლობა-ჲ	Verdoppelung
უმჯობლობა-ჲ	Untauglichkeit
უმადლობა-ჲ	Undankbarkeit; Undankbarkeit
მამლობა-დედლობა-ჲ	Paarung bei Tieren
მამალ-დედლობა-ჲ	Paarung der Tiere
შუაკედლობა-ჲ	Trennwand, Trennmauer
მრავალსასყიდლობა-ჲ	Teuersein
ჰრომაელობა-ჲ	Römertum
მნებებელობა-ჲ	Wünschen
მიმგებელობა-ჲ	Entgelten
წინაგანმგებელობა-ჲ	Fürsorge, Ordnung, Festlegung
მომგებელობა-ჲ	Gewinnen, Erwerben
სიტყჳსმგებელობა-ჲ	Antworten, Streiten
მარგებელობა-ჲ	Güte, Nutzen
განუგებელობა-ჲ	Unordentlichkeit
დამბადებელობა-ჲ	Erschaffung, Zeugung, Geburt
განუმზადებელობა-ჲ	Unvorbereitetheit
წინაგანუმზადებელობა-ჲ	Unvorbereitetheit
დაუცადებელობა-ჲ	Ununterbrochenheit
ჴელთსაგდებელობა-ჲ	Einfangen, Ergreifen
განსაგდებელობა-ჲ	Wegwerfen, Entfernen
ჴელუგდებელობა-ჲ	Unfaßbarkeit, Ungreifbarkeit
მართლმადიდებელობა-ჲ	Orthodoxie
სადიდებელობა-ჲ	Preis, Verehrung, Ruhm
დამდებელობა-ჲ	Festlegen, Festsetzen, Bestimmen
თავსმდებელობა-ჲ	Aufsichnehmen, Ertragen
საზღვრისმდებელობა-ჲ	Grenzfestlegung
მოულოდებელობა-ჲ	Unerwartetheit
შეუცოდებელობა-ჲ	Unschuld, Reinheit
მიმწოდებელობა-ჲ	Aufhetzen, Anstacheln
მაზავებელობა-ჲ	Versöhnen
აღუზუავებელობა-ჲ	Bescheidenheit
კეთილადშემსწავებელობა-ჲ	richtiges Verständnis
შეუსწავებელობა-ჲ	Fremdheit
დამტევებელობა-ჲ	Verlassen, Zurücklassen
განმაქარვებელობა-ჲ	Vernichten
განმქარვებელობა-ჲ	Vernichtung
განუქარვებელობა-ჲ	Beständigkeit, Ewigkeit
წარსამართებელობა-ჲ	Machen, Gelingen
მმართებელობა-ჲ	Führung, Leitung, Fürsorge
ერთმმართებელობა-ჲ	Einzelführung, Einzelherrschaft
წარუმართებელობა-ჲ	Niederlage
შემაერთებელობა-ჲ	Verknüpfbarkeit
გამომეძიებელობა-ჲ	Untersuchung, Erforschung
სიტყუაგამომეძიებელობა-ჲ	Untersuchung, Erforschung
შესაცვალებელობა-ჲ	Veränderung
უცვალებელობა-ჲ	Unveränderlichkeit, Beständigkeit
შეუცვალებელობა-ჲ	Unveränderlichkeit, Festigkeit
განუწვალებელობა-ჲ	Unerschütterlichkeit, Ganzheit
დაუმდაბლებელობა-ჲ	Höhe, Größe, Dreistheit
მიმმადლებელობა-ჲ	Schenken
განმაცხოველებელობა-ჲ	Wiederbelebungskraft
განმაძნელებელობა-ჲ	Belästigung
განუმრავლებელობა-ჲ	Unvermehrbarkeit
განმანათლებელობა-ჲ	Erhellung, Erleuchtung
დაუმორჩილებელობა-ჲ	Unbeugsamkeit
მაცილებელობა-ჲ	Streit, Widerspenstigkeit
მამხილებელობა-ჲ	Bezichtigen, Beschuldigen, Entlarven
დამაკლებელობა-ჲ	Vermindern, Verringern
დამაბრკოლებელობა-ჲ	Verführung
დაუბრკოლებელობა-ჲ	Unfehlbarkeit
შეუორგულებელობა-ჲ	Treue
განმასრულებელობა-ჲ	Beendigung, Vollendung
დაუსრულებელობა-ჲ	Endlosigkeit
უიძულებელობა-ჲ	Zwanglosigkeit, Freiwilligkeit
შესაძლებელობა-ჲ	Möglichkeit
შემძლებელობა-ჲ	Können, Kraft, Vermögen
შეუძლებელობა-ჲ	Unmöglichkeit, Unfähigkeit
განმაახლებელობა-ჲ	Erneuerung, Erneuerbarkeit
მიუახლებელობა-ჲ	Ferne
ცილისმწამებელობა-ჲ	Verleumdung
დამამძიმებელობა-ჲ	Belästigung
მბანებელობა-ჲ	Waschen, Baden
გამოუთარგმანებელობა-ჲ	Unerklärlichkeit, Unerklärbarkeit
მბრძანებელობა-ჲ	Befehlen, Herrschen
შემაჴსენებელობა-ჲ	Erinnerung
მომჴსენებელობა-ჲ	Erwähnen, Nennen, Erinnern
ძჳრუჴსენებელობა-ჲ	Verzeihen, Vergebung
დამაყენებელობა-ჲ	Stören
განმაყენებელობა-ჲ	Trennen
მავნებელობა-ჲ	Schädigung
მატკივნებელობა-ჲ	Schmerz
მვნებელობა-ჲ	Schädigen, Schaden
უვნებელობა-ჲ	Unversehrtheit, Vollständigkeit; Unversehrtheit, Vollständigkeit
მაგინებელობა-ჲ	Schimpfen
დამადგინებელობა-ჲ	Festlegen, Festsetzen, Bestimmen
მაკუდინებელობა-ჲ	Töten, Mord
მიმავლინებელობა-ჲ	Senden, Absenden
თანაჯერმჩინებელობა-ჲ	Einverständnis
გამოუჩინებელობა-ჲ	Unsichtbarkeit
უქორწინებელობა-ჲ	Unverheiratetheit
საგონებელობა-ჲ	Zweifel, Annahme, Mutmaßung
მგონებელობა-ჲ	Dafürhalten, Betrachten
მომგონებელობა-ჲ	Gedanke, Verstand
განმკანონებელობა-ჲ	Verurteilung
მქონებელობა-ჲ	Haben, Besitzen
უკურნებელობა-ჲ	Unheilbarkeit
უნებელობა-ჲ	Unwilligkeit
მაცთუნებელობა-ჲ	Verführung
დასარწმუნებელობა-ჲ	Glaubwürdigkeit
შეუძრწუნებელობა-ჲ	Furchtlosigkeit
მადროებელობა-ჲ	Fristverlängerung
განსაპატიჟებელობა-ჲ	Bestrafen; Schuld
მჴმარებელობა-ჲ	Gebrauchen, Verwenden
შემწყნარებელობა-ჲ	Gehorsam, Annahme
ღმრთიშემწყნარებელობა-ჲ	Gottgläubigkeit, Gottbekennung
განმამწარებელობა-ჲ	Belästigung
მახარებელობა-ჲ	Benachrichtigung
მოუმედგრებელობა-ჲ	Aufrichtigkeit, Hartnäckigkeit, Fleiß
მკადრებელობა-ჲ	Wagen, Wagnis
უკადრებელობა-ჲ	Unzulässigkeit
მვედრებელობა-ჲ	Flehen, Bitten
მაყუედრებელობა-ჲ	Beschuldigen, Vorhaltung, Vorwurf
სამკჳდრებელობა-ჲ	Ansiedelung
შემანაწევრებელობა-ჲ	Vereinigung
განუშოვრებელობა-ჲ	Untrennbarkeit, Ganzheit
გარეშეუსაზღვრებელობა-ჲ	Grenzenlosigkeit
შესაკრებელობა-ჲ	Versammlung
კიდეშესაკრებელობა-ჲ	gesonderte Versammlung
შემომკრებელობა-ჲ	Versammlung
წყლისმკრებელობა-ჲ	Wassersammeln
განუშორებელობა-ჲ	Untrennbarkeit, Ganzheit; Untrennbarkeit, Ganzheit
განმასწორებელობა-ჲ	Begradigen, Verbessern, Berichtigen
სამსახურებელობა-ჲ	Dienen
განუვაჭრებელობა-ჲ	Unverkäuflichkeit
განმაწესებელობა-ჲ	Festlegung, Festlegen
შეუმსგავსებელობა-ჲ	Unangemessenheit
მაქებელობა-ჲ	Lob, Preis
კეთილმაქებელობა-ჲ	Preisen, Rühmen
საქებელობა-ჲ	Lob, Preis
ამღებელობა-ჲ	Nehmen, Einnehmen, Erhalten, Bekommen, Einnahme, Annahme, Entgegennahme
მიმღებელობა-ჲ	Wegnehmen; Gutheißen, Anerkennung, Anhörung
განმაძღებელობა-ჲ	Sättigen
განუძღებელობა-ჲ	Unersättlichkeit
დამვიწყებელობა-ჲ	Vergessen, Mißachtung
დამწყებელობა-ჲ	Anfangen, Beginnen
დაუწყებელობა-ჲ	Anfangslosigkeit
წარსატაცებელობა-ჲ	Entführung, Raub
მტაცებელობა-ჲ	Rauben, Wegnehmen
დამამტკიცებელობა-ჲ	Bestätigung
შემამტკიცებელობა-ჲ	Bestätigung, Bekräftigung, Vereinigung
დაუმტკიცებელობა-ჲ	Unbeständigsein, Schwanken
მიმნიჭებელობა-ჲ	Schenken
მომნიჭებელობა-ჲ	Schenken
მავასხებელობა-ჲ	Verleihen, Geldverleihen
შეუხებელობა-ჲ	Unberührtheit, Unberührbarkeit
შემაწუხებელობა-ჲ	Belästigung, Behinderung
დამატკბობელობა-ჲ	Versüßen
შესანდობელობა-ჲ	Vergebbarkeit, Vergebung
შემნდობელობა-ჲ	Vergebung
მტრიობელობა-ჲ	Zügellosigkeit, Hemmungslosigkeit
მამხიობელობა-ჲ	Sehenswürdigkeit
მგალობელობა-ჲ	Gesang
ღმრთისმგალობელობა-ჲ	Gottesverherrlichung
მაბრალობელობა-ჲ	Beschuldigen; Beschuldigen
მაგრილობელობა-ჲ	Kühlung
საცილობელობა-ჲ	Streit
უცილობელობა-ჲ	Unbestreitbarkeit
მახლობელობა-ჲ	Nähe, Nahestehen
მჴმობელობა-ჲ	Herbeirufen, Rufen
მადნობელობა-ჲ	Schmelzen
დაუდნობელობა-ჲ	Traurigkeit, Schwermut
მაზმნობელობა-ჲ	Verführung
საცნობელობა-ჲ	Bewußtsein, Verständnis
მცნობელობა-ჲ	Erfahren, Verstehen, Wissen
წინამცნობელობა-ჲ	Vorauserkennen
მხოლოდმცნობელობა-ჲ	Alleinwissen
კეთილმცნობელობა-ჲ	Verstehen, Verständnis, Verstand
წინაწარმცნობელობა-ჲ	Vorhererfahren
წინაჲსწარმცნობელობა-ჲ	Vorauserkennen
უცნობელობა-ჲ	Dummheit, Unverständnis; Dummheit, Unverständnis
კეთილმგრძნობელობა-ჲ	Verstehen, Begreifen
უგრძნობელობა-ჲ	Unverständnis
დაუჭნობელობა-ჲ	Unverwelktheit
დასაპყრობელობა-ჲ	Beschwichtigung
ჴელისამპყრობელობა-ჲ	Hilfe, Unterstützung
სოფლისმპყრობელობა-ჲ	Regieren des Landes
საყდრისმპყრობელობა-ჲ	Bischofsamt
დაუპყრობელობა-ჲ	Nichtzurückhaltung, Ungeduld
შეუპყრობელობა-ჲ	Freiheit
მვაჭრობელობა-ჲ	Handel, Handeln
მთხრობელობა-ჲ	Erzählen, Sprechen
მომთხრობელობა-ჲ	Erzählen
მიუთხრობელობა-ჲ	Unsagbarkeit, Unsäglichkeit
განმატფობელობა-ჲ	Wärmen
მშობელობა-ჲ	Elternstand
უშობელობა-ჲ	Ungeborensein
განმბჭობელობა-ჲ	Richten
მდრანჯობელობა-ჲ	schamloses Hofmachen
საძაგელობა-ჲ	Abscheulichkeit
საწადელობა-ჲ	Wunsch, Sehnen
სიტყუასაწადელობა-ჲ	Geschwätzigkeit
წარმწყმედელობა-ჲ	Vernichtung
განმწმედელობა-ჲ	Reinigen
განმსყიდელობა-ჲ	Verkaufen
დამწინდელობა-ჲ	Verlobung
უსაზრდელობა-ჲ	Hunger, Nahrungsmittelmangel
მზრდელობა-ჲ	Ernähren, Aufziehen, Erziehen
ჭაბუკთმზრდელობა-ჲ	Jugenderziehung
მფრდელობა-ჲ	Handeln
გამომცდელობა-ჲ	Anblick, Aufsicht
განუცდელობა-ჲ	Unsichtbarkeit
წინამხედველობა-ჲ	Voraussicht
მრუმედმხედველობა-ჲ	Schwachsichtigkeit
წინაწარმხედველობა-ჲ	Vorhersehen
წინააღმზიდველობა-ჲ	Hochheben, Emporheben
მცოდველობა-ჲ	Sündigen
მარბეველობა-ჲ	Angreifen, überfallen, Anspornen
ზედამარბეველობა-ჲ	Angriff
განმლეველობა-ჲ	Zerstören, Vernichten
გამოუკულეველობა-ჲ	Unerforschbarkeit
მძლეველობა-ჲ	Geben; überwinden, Siegen
კათაკუმეველობა-ჲ	Ungetauftheit
მჴუმეველობა-ჲ	Benutzen, Gebrauchen, Verwenden
განმაბნეველობა-ჲ	Verstreuen, Vertreibung
განუბნეველობა-ჲ	Aufmerksamkeit, Konzentration
მიმოგანუბნეველობა-ჲ	Aufmerksamkeit
შემამრღუეველობა-ჲ	Durcheinanderbringen
შეუმრღუეველობა-ჲ	Frieden, Ruhe
უჩუეველობა-ჲ	Ungewöhnlichkeit
მისამთხუეველობა-ჲ	Finden
მიუმთხუეველობა-ჲ	Unverständnis
შეურყეველობა-ჲ	Unerschütterlichkeit, Festigkeit
განმარჩეველობა-ჲ	Auswählen
განსარჩეველობა-ჲ	Unterscheiden
აღმრჩეველობა-ჲ	Auswahl, Wahl
მიმომქცეველობა-ჲ	Schwanken
უქცეველობა-ჲ	Festigkeit, Unveränderlichkeit
გარეშეუქცეველობა-ჲ	Richtigkeit
მოუქცეველობა-ჲ	Reuelosigkeit
მაკურთხეველობა-ჲ	Segnen
უთხზველობა-ჲ	Ungeflochtenheit
მროკველობა-ჲ	Tanzen
მიმთუალველობა-ჲ	Erhalten, Annehmen
მოუთუალველობა-ჲ	Mißachtung
სახილველობა-ჲ	Schauen, Anblick, Lage
განმხილველობა-ჲ	Erblicken; Untersuchen, Richten
წინაგანმხილველობა-ჲ	vorherige Berücksichtigung
მკლველობა-ჲ	Töten, Mord
ანკანაკობით მკლველობა-ჲ	aus Unbedachtsamkeit begangener Totschlag
მიდებელობით მკლველობა-ჲ	unbedachter Totschlag
ყრმათმკლველობა-ჲ	Kindermord
უცხოთმკლველობა-ჲ	Tötung eines Fremden
მომწამლველობა-ჲ	Zaubern, Vergiften
მყურიმლველობა-ჲ	Ohrfeige
განუვლთოლველობა-ჲ	Unumgänglichkeit
ულპოლველობა-ჲ	Unvergänglichkeit, Unverdorbenheit
მომსპოლველობა-ჲ	Vernichten
სალტოლველობა-ჲ	Ausweichen, Fliehen, Meiden
მჴედართმძღუანველობა-ჲ	Feldherrenamt
წარუტყუენველობა-ჲ	Unentführbarkeit, Schutz, Bewahrung
მკუთნველობა-ჲ	Bekenntnis
განმკუთნველობა-ჲ	Aneignung
დამთრგუნველობა-ჲ	Zerstampfen
დაუთრგუნველობა-ჲ	Ungestampftheit, Stärke
წინამზრუნველობა-ჲ	Fürsorge
სულთმზრუნველობა-ჲ	Seelsorge
მრავალმზრუნველობა-ჲ	große Fürsorge
მბრტჳნველობა-ჲ	Dreistigkeit
მქსოველობა-ჲ	Weben
მთხოველობა-ჲ	Bitten, Betteln
ცხოველობა-ჲ	Leben; Leben
წარუპარველობა-ჲ	Schutz, Bewahrung
მბერველობა-ჲ	Blasen, Einhauchen, Anspornen
მჭკუერველობა-ჲ	Raub, Diebstahl
მწირველობა-ჲ	Abhaltung des Gottesdienstes
შემწირველობა-ჲ	Opferung
მართლშემწირველობა-ჲ	richtiges Opfern
მსხუერპლისშემწირველობა-ჲ	Opferbringen
ნაყოფისშემწირველობა-ჲ	Opfern
საჭირველობა-ჲ	Not, Schwierigkeit
დაუმჭირველობა-ჲ	Ungestüm
უჭირველობა-ჲ	Leichtigkeit
შემკრველობა-ჲ	Binden, Fesseln, Behindern
მოსასრველობა-ჲ	Vernichtung, Ausrottung
მომსრველობა-ჲ	Vernichten
უბურველობა-ჲ	Unverhülltheit
თავდაუბურველობა-ჲ	Unverhülltsein des Kopfes
სასურველობა-ჲ	Erwünschtheit
უურველობა-ჲ	Sorglosigkeit, Unbekümmertheit
უშურველობა-ჲ	Freigebigkeit
მძრველობა-ჲ	Anstacheln, Aufhetzen, Klagen
შეუძრველობა-ჲ	Festigkeit, Unerschütterlichkeit
განსაკჳრველობა-ჲ	Erstaunen, Verwunderung
მთესველობა-ჲ	Säen
უპარსველობა-ჲ	Unrasiertheit, Ungeschnittenheit
უტყუველობა-ჲ	Wahrheit
მწუველობა-ჲ	Verbrennen
მომრწყველობა-ჲ	Kühlen
გარეშემცველობა-ჲ	Eingrenzung, Begrenzung
საუნჯეთმცველობა-ჲ	Schatzhüten
წარმცველობა-ჲ	Beobachtung, Aufsicht
მლოცველობა-ჲ	Beten, Flehen
საფუძველობა-ჲ	Grundlegung
განუნახველობა-ჲ	Unbedachtsamkeit
მაღალმზრახველობა-ჲ	Dreistigkeit, Hochmut
მაღლისმზრახველობა-ჲ	Hochmut
განუზრახველობა-ჲ	Unbedachtheit, Unabgestimmtheit
მსახველობა-ჲ	Ausdruck
დამსახველობა-ჲ	Schaffen, Darstellen
მკრეხველობა-ჲ	Rauben, Plündern
ეკლესიათმკრეხველობა-ჲ	Kirchenraub
სიწმიდეთმკრეხველობა-ჲ	Plündern von Heiligtümern
სამღდელოთმკრეხველობა-ჲ	Entwendung von Kirchengut
წიგნისმკითხველობა-ჲ	Vorlesen (in der Liturgie)
განუკითხველობა-ჲ	Unbestrafbarkeit, Dummheit
დამმარხველობა-ჲ	Bewahrung, Schutz
შეურისხველობა-ჲ	Ruhe, Sanftheit
განურისხველობა-ჲ	Friedfertigkeit
მომმუხველობა-ჲ	Verbrennen, Aufplatzen
შესარაცხველობა-ჲ	Dafürhalten
მტანჯველობა-ჲ	Peinigen, Quälen
მომკუეთელობა-ჲ	Abschneiden
განუკუეთელობა-ჲ	Unteilbarkeit, Ganzheit
დაუცუეთელობა-ჲ	Unbeschnittenheit
წინადაუცუეთელობა-ჲ	Unbeschnittenheit; Unbeschnittenheit
მწურთელობა-ჲ	Lehren, Unterrichten, Abrichten
მიუდრეკელობა-ჲ	Unbeugsamkeit, Hartnäckigkeit, Richtigkeit
მასწავლელობა-ჲ	Lehren, Unterrichten
სასწავლელობა-ჲ	Lehrbefähigung
დამსწავლელობა-ჲ	Lernen, Studium
უბრძოლელობა-ჲ	Ruhe, Friedlichkeit
საძულელობა-ჲ	Haß
მსოფლელობა-ჲ	Ungebildetheit, Analphabetentum, Laientum
მჭამელობა-ჲ	Essen, Aufessen
იდუმალმჭამელობა-ჲ	heimliches Essen
შეუკდემელობა-ჲ	Unverschämtheit
მგუემელობა-ჲ	Schlagen, Peinigen
მიმცემელობა-ჲ	übergeben, Ausliefern, Schenken
სასყიდლისმიმცემელობა-ჲ	Bezahlen, Vergelten
მომცემელობა-ჲ	Geben
ნაყოფთმომცემელობა-ჲ	Fruchttragen
პატივისმცემელობა-ჲ	Verehrung
საზღვისმცემელობა-ჲ	Bezahlen, Begleichen, Vergüten
ნათლისმცემელობა-ჲ	Taufen
თაყუანისმცემელობა-ჲ	Verehren
განუცემელობა-ჲ	Unauslieferbarkeit, Unauslaßbarkeit, Treue
წინაშემდგომელობა-ჲ	Vorstehen
წინადაუდგომელობა-ჲ	Widerstandslosigkeit
განუვრდომელობა-ჲ	Ständigkeit, Untrennbarkeit
მიუწუდომელობა-ჲ	Unverständnis
მისაწდომელობა-ჲ	Erreichbarkeit, Verständlichkeit
მიუწდომელობა-ჲ	Unverständnis; Unverständnis
ზედამჯდომელობა-ჲ	Obensitzen, Vornsitzen
პირველმჯდომელობა-ჲ	Vorsitzen, Leiten
განმზომელობა-ჲ	Messen
ქუეყანისმზომელობა-ჲ	Geometrie
მისაწთომელობა-ჲ	Erreichbarkeit, Verständlichkeit; Erreichbarkeit, Verständlichkeit
მიმწთომელობა-ჲ	Begreifen, Verstehen
მიუწთომელობა-ჲ	Unverständnis; Unverständnis
დაუდგრომელობა-ჲ	Unstetigkeit
წინადაუდგრომელობა-ჲ	Widerstandslosigkeit
მშრომელობა-ჲ	Arbeit, Tun, Schaffen
ქუეყანისმშრომელობა-ჲ	Bodenbearbeitung
უშრომელობა-ჲ	Leichtigkeit, Mühelosigkeit
დაუცხრომელობა-ჲ	Unermüdlichkeit
განუძღომელობა-ჲ	Unersättlichkeit
დაუდუმელობა-ჲ	Ständigkeit
ნაყოფთმრთუმელობა-ჲ	Versprechen, Anbieten
ნაყოფისმომრთუმელობა-ჲ	Geschenküberreichen
ნაყოფმრთუმელობა-ჲ	Steuereintreibung
ჩამსუმელობა-ჲ	Geben, Schenken
გამოსათქუმელობა-ჲ	Aussprechbarkeit; Erklärbarkeit
გულისსათქუმელობა-ჲ	Wunsch
წარმომთქუმელობა-ჲ	Sprechen, Sagen
აღმთქუმელობა-ჲ	Versprechen, Gelübde
უთქუმელობა-ჲ	Unaussprechlichkeit, Schweigsamkeit
გამოუთქუმელობა-ჲ	Unaussprechlichkeit
მრავალსაჭმელობა-ჲ	Lebensmittelüberfluß
ძარღუთმრთხმელობა-ჲ	Dehnen der Sehnen; Rettung, Erlösung
ჴელთდამსხმელობა-ჲ	Einsetzen, Festlegen; Widerstand
წესთდამსხმელობა-ჲ	Festlegung, Anordnung, Bestimmung
განჴმელობა-ჲ	Trockenheit, Dürre, Unfruchtbarkeit
ჴელუბანელობა-ჲ	Ungewaschenheit der Hände
ჴმანელობა-ჲ	Notwendigkeit, Verwendung
უნანელობა-ჲ	Reuelosigkeit
მცოდნელობა-ჲ	Wissen
მიმავლენელობა-ჲ	Senden, Schicken
მასმენელობა-ჲ	Verleumdung
სასმენელობა-ჲ	Hören, Gehör
მსმენელობა-ჲ	Hören, Gehorchen, Bereuen
კეთილადმსმენელობა-ჲ	Gehorsam
უსმენელობა-ჲ	Ungehorsam
მგზავნელობა-ჲ	Absenden
მდევნელობა-ჲ	Verfolgung
განულევნელობა-ჲ	Ständigkeit
შემრევნელობა-ჲ	Stören, Durcheinanderbringen
შეურევნელობა-ჲ	Unvermischtheit, Reinheit
შეუწევნელობა-ჲ	Unterstützungslosigkeit, Hilflosigkeit
სძისმწოვნელობა-ჲ	Saugen an der Brust
უთხზნელობა-ჲ	Ungeflochtenheit
მოსაწყინელობა-ჲ	Abscheulichkeit
გარესკნელობა-ჲ	Außenwelt
უკუანაჲსკნელობა-ჲ	Ende, Schluß; Ende, Schluß
შემქმნელობა-ჲ	Erschaffung
შვილთმქმნელობა-ჲ	Kinderzeugung, Kinderhaben
შეუქმნელობა-ჲ	Ungezeugtheit, Ungeborenheit
უქონელობა-ჲ	Armut; Armut
უცონელობა-ჲ	Fleiß; Fleiß
სურნელობა-ჲ	Duft
სახეთმწმასნელობა-ჲ	Grimasseschneiden
დასაჴსნელობა-ჲ	Zerrüttung, Auflösung
დამჴსნელობა-ჲ	Zerrütten, Zerstören
განმრყუნელობა-ჲ	Verderben
განურყუნელობა-ჲ	Reinheit; Reinheit
მლიქნელობა-ჲ	Schmeicheln, Lobhudeln
მაცთურმლიქნელობა-ჲ	Schmeicheln und Verführen
მხრწნელობა-ჲ	Verderben, Vergewaltigung
ურცხჳნელობა-ჲ	Schamlosigkeit
საზარელობა-ჲ	Scheußlichkeit; Scheußlichkeit
საყუარელობა-ჲ	Liebe
გარეშეუწერელობა-ჲ	Grenzenlosigkeit
გარეშემოუწერელობა-ჲ	Grenzenlosigkeit
შეუსაზღვრელობა-ჲ	Unbegrenztheit, Grenzenlosigkeit
ნაწლევთმჭრელობა-ჲ	Wahrsagerei
მდრესელობა-ჲ	Reiben, Wetzen
უსიტყუელობა-ჲ	Stummheit
საეჭუელობა-ჲ	Zweifelhaftigkeit
მეჭუელობა-ჲ	Zweifel, Argwohn, Mißtrauen
კმასაყოფელობა-ჲ	Genügen, Genugbekommen
შეურაცხისსაყოფელობა-ჲ	Mißachtung
მყოფელობა-ჲ	Machen, Tun
უდებმყოფელობა-ჲ	Mißachtung, Faulheit
ცხადმყოფელობა-ჲ	Aufdecken, Offenbaren
ჴელმყოფელობა-ჲ	Machen, Tun, Begehen, Verrichten
სრულმყოფელობა-ჲ	Beenden, Vollenden, Erfüllen
განმყოფელობა-ჲ	Teilen, Verteilen
მართლგანმყოფელობა-ჲ	richtiges Aufteilen
მშჳდობისმყოფელობა-ჲ	Frieden, Friedensstiften
თეატრონისმყოფელობა-ჲ	Vorführung, Darstellung, Aufführung
შეურაცხისმყოფელობა-ჲ	Mißachtung
უგულებელსმყოფელობა-ჲ	Mißachtung
ცხოველსმყოფელობა-ჲ	Belebung
განუყოფელობა-ჲ	Beständigkeit, Ganzheit
წფელობა-ჲ	Anständigkeit, Ehrlichkeit, Reinheit, Wahrhaftigkeit
ზრქელობა-ჲ	Dicke, Stärke, Beleibtheit
კიცუთმწყელობა-ჲ	Abrichten des Fohlens
ჴმელსარეცელობა-ჲ	Liegen auf einem Bretterbett
ცუდსახელობა-ჲ	Falschheit
ჩარბფიცხელობა-ჲ	Scharfschnäbeligkeit
ზეაღმავლობა-ჲ	Hinaufgehen
შვილმრავლობა-ჲ	Kinderreichtum
ცრემლმრავლობა-ჲ	große Trauer
ერმრავლობა-ჲ	Volkreichtum
ცხოვლობა-ჲ	Leben; Leben
უცხოვლობა-ჲ	Leblosigkeit
უსაგზლობა-ჲ	Proviantlosigkeit
უგბილობა-ჲ	Wut, Raserei, Grausamkeit
გონებატკბილობა-ჲ	Friedfertigkeit
შემკობილობა-ჲ	Schmuck, Schönheit; Schmuck, Schönheit
ბრალობილობა-ჲ	Beschuldigung
პყრობილობა-ჲ	Fangen, Gefangennehmen; Fangen, Gefangennehmen
განწყობილობა-ჲ	Ordnung
შობილობა-ჲ	Geburt, Zeugung
მხოლოდშობილობა-ჲ	Besitz nur eines Sohnes; Besitz nur eines Sohnes
განწმედილობა-ჲ	Reinigung
თმაზრდილობა-ჲ	Wachsen des Haares
შინაზრდილობა-ჲ	häusliche Aufzucht
განფრდილობა-ჲ	Sein, Sichbefinden
გარდაჴდილობა-ჲ	ertragene Not
მიჴდილობა-ჲ	Bezahlung
განჴდილობა-ჲ	Vertreibung, Austreibung
უადვილობა-ჲ	Schwierigkeit
გარემოზღუდვილობა-ჲ	Ummauerung, Festung
განკუთნვილობა-ჲ	übereignung; Eigentum
ენაბრგუნვილობა-ჲ	Stottern
ქსოვილობა-ჲ	Weben
დაბურვილობა-ჲ	Bedecken, Verhüllen, Bedeckung, Verhüllung
თავდაბურვილობა-ჲ	Kopfverhüllung
გზაკეთილობა-ჲ	gute Reise
ჴმაკეთილობა-ჲ	angenehmer Klang
სიტყუაკეთილობა-ჲ	Redekunst, Rhetorik
ნათესავკეთილობა-ჲ	Adel, vornehme Herkunft
მამულკეთილობა-ჲ	Adel
სულკეთილობა-ჲ	Seelengüte
ნაყოფკეთილობა-ჲ	Fruchtbarkeit
ქედდადრეკილობა-ჲ	Gehorsam
განდრეკილობა-ჲ	Abfall, Verrat, Abweichen; Abfall, Verrat, Abweichen
მოდრეკილობა-ჲ	Krummheit, Gekrümmtheit
განდგომილობა-ჲ	Abfall, Verrat; Abfall, Verrat
წარმოდგომილობა-ჲ	Kommen, Herbringen; Kommen, Herbringen
გარდამოვრდომილობა-ჲ	Herabfallen, Herüberkommen
გონებაცთომილობა-ჲ	Wahnsinn, Dummheit; Wahnsinn, Dummheit
გრაგნილობა-ჲ	Wickeln, Einwickeln
სმენილობა-ჲ	Gehörthaben
მართლგანფენილობა-ჲ	Ausbreiten, Verbreiten
განდევნილობა-ჲ	Vertreibung
პოვნილობა-ჲ	Finden; Existieren
მოძოვნილობა-ჲ	Auffressen, Weiden, Vernichten
ქმნილობა-ჲ	Machen, Schaffen
უცხოქმნილობა-ჲ	Entfernen
განჴსნილობა-ჲ	Lösen
წარჴსნილობა-ჲ	Zügellosigkeit
განრყუნილობა-ჲ	Verderben; Verderben
გულარძნილობა-ჲ	Beugen, Neigen, Verraten, Heimtücke; Beugen, Neigen, Verraten, Heimtücke
ფარილობა-ჲ	beginnender Bartwuchs
მიყრილობა-ჲ	Hinwerfen
განჭრილობა-ჲ	Teilen, Trennen; Teilen, Trennen
მოსილობა-ჲ	Ankleiden
განყოფილობა-ჲ	Verteilung; Verteilung
სათნოყოფილობა-ჲ	Gefallen; Gefallen
ღირსყოფილობა-ჲ	Würde, Ehre
მოძილობა-ჲ	Schläfrigkeit
მრავალნაწილობა-ჲ	großer Teil, mehr Anteile
სწორნაწილობა-ჲ	Richtigkeit
უნაწილობა-ჲ	Anteillosigkeit
მიხუეჭილობა-ჲ	Rauben, Wegnehmen, Unterdrücken
შერაცხილობა-ჲ	Betrachten, Dafürhalten; Vornehmheit; Betrachten, Dafürhalten; Vornehmheit
შეუკდემლობა-ჲ	Unverschämtheit; Unverschämtheit
მიმომრდომლობა-ჲ	Umherbewegen, Umherhasten
სასუმლობა-ჲ	Adoption, Behandlung als Nahestehenden
თანამყოლობა-ჲ	Zusammensein
მებრძოლობა-ჲ	Kampf, Streit
მბრძოლობა-ჲ	Kampf
კეთილადმბრძოლობა-ჲ	Kämpfen
მჴეცთმბრძოლობა-ჲ	Kampf gegen wilde Tiere
ცეცხლისმბრძოლობა-ჲ	Kampf gegen das Feuer
გარდამწერლობა-ჲ	Abschreiben
ხატთმწერლობა-ჲ	Bildermalerei
კეთილმწერლობა-ჲ	Kalligraphie
სიტყჳსმწერლობა-ჲ	Schreiben
უთესლობა-ჲ	Unfruchtbarkeit
უხილავნისლობა-ჲ	Verschwinden im Nebel
სატლობა-ჲ	Durchfall
სასწაულობა-ჲ	Wundertätigkeit
თანადღესასწაულობა-ჲ	gemeinsames Feiern
თავს-დებულობა-ჲ	Aufsichnehmen
დაბადებულობა-ჲ	Geburt, Erschaffung; Geburt, Erschaffung
წინადაბადებულობა-ჲ	Erstgeburt, frühere Existenz
დადებულობა-ჲ	Legen
შეცოდებულობა-ჲ	Sündigkeit; Sündigkeit
წოდებულობა-ჲ	Herbeirufen, Benennung
ღმრთივწოდებულობა-ჲ	Gottberufenheit
შეზავებულობა-ჲ	Vermischen, Verbinden, Anrichten; Vermischen, Verbinden, Anrichten
დატევებულობა-ჲ	Dalassen, Zurücklassen
შეერთებულობა-ჲ	Einigkeit
ცვალებულობა-ჲ	Veränderlichkeit
დაკლებულობა-ჲ	Verringerung, Mangel; Verdruß, Schmerz; Verringerung, Mangel; Verdruß, Schmerz
მომრგულებულობა-ჲ	Rundheit
შესრულებულობა-ჲ	Beendung, Vollendung, Erreichung, Vervollkommnung
უფლებულობა-ჲ	Herrschaft, Recht; Herrschaft, Recht
განთავისუფლებულობა-ჲ	Befreiung, Freiheit
წამებულობა-ჲ	Bezeugung, Bestätigung; Bezeugung, Bestätigung
დადუმებულობა-ჲ	Verstummen, Verbergen
მოყვანებულობა-ჲ	Herholen, Herführen
ყენებულობა-ჲ	Anhalten, Festhalten
დაყენებულობა-ჲ	Aufhalten; Ungläubigkeit
შეყენებულობა-ჲ	Umzingelung, Einschließung
შეგინებულობა-ჲ	Entehrung, Schändung, Schmähung
მოვლინებულობა-ჲ	Hersenden; Hersenden
ჩინებულობა-ჲ	Herbeirufen, Einladen, Festlegen, Erscheinen; Adel; Herbeirufen, Einladen, Festlegen, Erscheinen; Adel
წინაჲსწარჩინებულობა-ჲ	Vorherbestimmung
ქორწინებულობა-ჲ	Heirat; Heirat
მრავალქორწინებულობა-ჲ	Polygamie
განკანონებულობა-ჲ	Verurteilung; Festlegung; Verurteilung; Festlegung
დაღონებულობა-ჲ	Bedrücktheit
დაწუნებულობა-ჲ	Verpönen, Bemängeln
განპატიჟებულობა-ჲ	Bestrafung
აღსაარებულობა-ჲ	Eingeständnis, Bekenntnis
დაწყნარებულობა-ჲ	Beruhigung, Besänftigung, Ruhe; Beruhigung, Besänftigung, Ruhe
წინაჲსწარხარებულობა-ჲ	Vorauserkennen, Vorankündigung
დამკჳდრებულობა-ჲ	Ansiedlung, Besiedlung, Vererbung
განშორებულობა-ჲ	Entfernen; Entfernen
განცოფებულობა-ჲ	Torheit, Verrücktheit; Torheit, Verrücktheit
განლაღებულობა-ჲ	Frechheit, Dreistheit
ნათელღებულობა-ჲ	Taufe; Taufe
შემტკიცებულობა-ჲ	Befestigung, Verbindung, Festigkeit, Bestätigung; Befestigung, Verbindung, Festigkeit, Bestätigung
ღმრთივმონიჭებულობა-ჲ	Gottesgeschenk
სახისჩუენებით-ი სესხებულობა-ჲ	betrügerisches Geldverleihen
უცხონაკადულობა-ჲ	ungewöhnliches Fließen
მოქადულობა-ჲ	Prahlen, Drohen, Rühmen; Prahlen, Drohen, Rühmen
დედულობა-ჲ	Gegend / Heimat der Mutter, Name nach der Mutter
თანამოკიდულობა-ჲ	Hinzufügung
მზარდულობა-ჲ	Erziehung
ვეცხლისმოფარდულობა-ჲ	Silberhandel
წელიწდეულობა-ჲ	Jahr, Alter
ურვეულობა-ჲ	Not, Bedrängnis, Fürsorge; Not, Bedrängnis, Fürsorge
ძლეულობა-ჲ	Niederlage; Niederlage
მცირეჯამეულობა-ჲ	kurzes Verspäten
მიმოდაბნეულობა-ჲ	Zerstreutheit, Geistesabwesenheit; Zerstreutheit, Geistesabwesenheit
განბნეულობა-ჲ	Verstreuen, Verjagen; Verstreuen, Verjagen
ბორგნეულობა-ჲ	Wahnsinn; Wahnsinn
თანატკივნეულობა-ჲ	Mitgefühl
თუალტკივნეულობა-ჲ	Augenschmerzen
გულტკივნეულობა-ჲ	Belästigung
სნეულობა-ჲ	Krankheit, Kranksein, Siechtum; Krankheit, Kranksein, Siechtum
ფუფუნეულობა-ჲ	Luxusleben, Verwöhnen
უჩუეულობა-ჲ	Erlesenheit, Ungewöhnlichkeit
მიმთხუეულობა-ჲ	Begegnung
შერყეულობა-ჲ	Beben, Erschütterung, Absetzung; Beben, Erschütterung, Absetzung
გერშეულობა-ჲ	Narbe
ძოწეულობა-ჲ	Purpurfarbe
დათხეულობა-ჲ	Vergießen, Verschütten, Herunterwerfen
დაზულობა-ჲ	Zerrüttung, Auflösung, Zerstörung
უსართულობა-ჲ	Obdachlosigkeit, Dachlosigkeit
კეთილმორთულობა-ჲ	Schönheit
შემშჭუალულობა-ჲ	Verbindung, Verknüpfung, Durchdringung
თანადუნაკლულობა-ჲ	Mangellosigkeit
მამულობა-ჲ	Erbe, Vatererbe
მეწამულობა-ჲ	Röte
ფერმეწამულობა-ჲ	Röte
მიდგმულობა-ჲ	Vertrauen; Geschlechtsverkehr
პატივცემულობა-ჲ	Verehrung, Stellung, Amt; Verehrung, Stellung, Amt
თაყუანისცემულობა-ჲ	Verehrung
თქუმულობა-ჲ	Sagen, Sprechen
სახელგანთქუმულობა-ჲ	Ruhm, Berühmtheit; Ruhm, Berühmtheit
აღთქუმულობა-ჲ	Versprechen, Vereinbarung; Versprechen, Vereinbarung
მუცელქუმულობა-ჲ	Schwangerschaft
დანთქმულობა-ჲ	Verschlingen, Verschlungenwerden, Versenken, Versinken; Verschlingen, Verschlungenwerden, Versenken, Versinken
მორტყმულობა-ჲ	Kleiden
გართხმულობა-ჲ	Ausdehnen
განრთხმულობა-ჲ	Ausbreiten, Ausdehnen
ჴელთდასხმულობა-ჲ	Einsetzen, Festlegen
წარტყუენულობა-ჲ	Verwüstung, Gefangennahme
მიწევნულობა-ჲ	Erreichen, Erlangen, Hingelangen
ზედმიწევნულობა-ჲ	Wissen, Erkennen, Verstehen
მოწევნულობა-ჲ	Kommen, Erreichen
აღწევნულობა-ჲ	Emporheben, Aufsteigen; Emporheben, Aufsteigen
ქმნულობა-ჲ	Werk, Aussehen, Anblick, Muster; Werk, Aussehen, Anblick, Muster
შექმნულობა-ჲ	Machen, Schaffen; Werk; Machen, Schaffen; Werk
უცხოქმნულობა-ჲ	Entfernen
თავმოყუარულობა-ჲ	Stolz; Stolz
ვეცხლისუყუარულობა-ჲ	Geldverachtung
დაფარულობა-ჲ	Verbergen, Geheimnis; Verbergen, Geheimnis
მოხარულობა-ჲ	Freude
შთასრულობა-ჲ	Hinabsteigen
მისრულობა-ჲ	Hingehen
მოსრულობა-ჲ	Kommen
გამოხატულობა-ჲ	Darstellen
ურწყულობა-ჲ	Wasserlosigkeit; Wasserlosigkeit
უწყულობა-ჲ	Wasserlosigkeit
შიშულობა-ჲ	Nacktheit
ჴშულობა-ჲ	Schließen, Verschlossenheit
მრავალრჩულობა-ჲ	Vielgötterglaube, Polytheismus
მრავალმარცულობა-ჲ	Vielzahl an Körnern
სეფეწულობა-ჲ	Höflingsstand
ძმისწულობა-ჲ	Neffesein, Nichtesein
მართლმსაჯულობა-ჲ	gerechtes Gericht; gerechtes Gericht
მოსაჯულობა-ჲ	Streit, Richten
თანამოსაჯულობა-ჲ	Beistand bei einer Klageführung
ქადება-ტანჯულობა-ჲ	Drohung und Folter
სამფლობა-ჲ	Dreifaltigkeit
თავისუფლობა-ჲ	Freiheit, Befreiung; Adel; Freiheit, Befreiung; Adel
ჴელისუფლობა-ჲ	Beruf, Amt
წარბმაღლობა-ჲ	Hochmut, Stolz
გულფიცხლობა-ჲ	Grausamkeit, Hartherzigkeit; Grausamkeit, Hartherzigkeit
ჩჩჳლობა-ჲ	Kleinkindalter
რაბამობა-ჲ	Beschaffenheit, Eigenschaft
ერთბამობა-ჲ	Einheit
გრძელშენადგამობა-ჲ	Länge
თუალთშეუდგამობა-ჲ	Unerreichbarkeit (mit den Augen)
თუალშეუდგამობა-ჲ	Unerreichbarkeit
ელამობა-ჲ	Schielen, Krummheit
ძე-მამობა-ჲ	Modalismus, Monarchianismus, Sabellianismus; Modalismus, Monarchianismus, Sabellianismus
უმამობა-ჲ	Vaterlosigkeit
წუთჟამობა-ჲ	Kurzzeitigkeit
მრწემობა-ჲ	Jüngersein; Gehorsam
უგლიმობა-ჲ	Unverschämtheit
ელმობა-ჲ	Schielen, Krummheit; Schielen, Krummheit
ქცევა-მდგომობა-ჲ	Verhalten
წინამდგომობა-ჲ	Führung
შემდგომობა-ჲ	Folge, Reihenfolge; Folge, Reihenfolge
წინაშემდგომობა-ჲ	Reihenfolge
სიტყუათშემდგომობა-ჲ	folgerichtiger Redeaufbau
წინააღმდგომობა-ჲ	Widerstand
ნარდომობა-ჲ	Liegen
მიმომრდომობა-ჲ	Umherbewegen, Umherhasten; Umherbewegen, Umherhasten
მჴდომობა-ჲ	Feindschaft, Streit
მკრთომობა-ჲ	Gelüste
მცთომობა-ჲ	Fehler
მიმომცთომობა-ჲ	Umherlungern
ჰრომობა-ჲ	Römertum
უსმობა-ჲ	Unbotmäßigkeit
თანამოწმობა-ჲ	Bezeugen; Bezeugen
ახალჴმობა-ჲ	Neubenennung
უჴმობა-ჲ	Schweigen
წინადაცუეთილებისაგანობა-ჲ	Beschneidung
წინადაუცუეთელობისაგანობა-ჲ	Unbeschnittenheit
ძუელითგანობა-ჲ	Ursprung, Anfang
ზემოჲთგანობა-ჲ	Anfang
მისგანობა-ჲ	Zugehörigkeit
საცთურეანობა-ჲ	Irrtum, Falschheit
მრავალსაცთურეანობა-ჲ	große Verführung, große Gefahr
ქრისტეანობა-ჲ	Christentum; Christentum
სახარულევანობა-ჲ	Freude; Freude
მჩივანობა-ჲ	Klage
ფრთოვანობა-ჲ	Besitz von Flügeln
ტჳრთიანობა-ჲ	Belastung
სისხლიანობა-ჲ	Blutvergießen
ძე-მამიანობა-ჲ	Modalismus, Monarchianismus, Sabellianismus
თმიანობა-ჲ	Haar
გუარიანობა-ჲ	Hochadel
საცთურიანობა-ჲ	Irrtum, Falschheit; Irrtum, Falschheit
ულვაშიანობა-ჲ	Schnurrbärtigkeit
წუთხიანობა-ჲ	Vereiterung
ჴორჴიანობა-ჲ	Laut, Geschrei
მანქანობა-ჲ	List, Tücke; List, Tücke
მიყდნობა-ჲ	Stützen, Anlehnen
რავდენობა-ჲ	Maß, Menge, Anzahl; Maß, Menge, Anzahl
ეგოდენობა-ჲ	solche Größe
ესოდენობა-ჲ	eine so große Zahl
ფრჩხილისოდენობა-ჲ	Winzigkeit
ჩუკენობა-ჲ	Feigheit, Onanie
ბრპენობა-ჲ	Blei, Bleimetall
ჴელოვნობა-ჲ	Meisterschaft, Handwerk, Beruf; Meisterschaft, Handwerk, Beruf
ჰავჴელოვნობა-ჲ	Schlechtigkeit, Bosheit, Bösartigkeit; Schlechtigkeit, Bosheit, Bösartigkeit
მაღლოვნობა-ჲ	Hochmut
ხუროვნობა-ჲ	Zimmermannsarbeit, Handwerk; Zimmermannsarbeit, Handwerk
მოლაზნობა-ჲ	Mönchsein, Nonnesein, Mönchwerden, Nonnewerden; Mönchsein, Nonnesein,
უაზნობა-ჲ	Sklaverei, Unfreiheit
ვინობა-ჲ	Herkunft; Herkunft
მრავალქორწინობა-ჲ	häufiges Heiraten
თარგმნობა-ჲ	übersetzen, Kommentieren; übersetzen, Kommentieren
ჳპატიონობა-ჲ	Stellung eines Hypatios (byz. Titel)
დიაკონობა-ჲ	Arbeit als Diakon
კერძოდიაკონობა-ჲ	Hypodiakonenamt
მთავარდიაკონობა-ჲ	Amt des Archidiakons
მეთეატრონობა-ჲ	Theaterliebe
ლიტონობა-ჲ	Einfachheit, Schlichtheit
მარზაპნობა-ჲ	Amt des Provinzverwalters in Persien
ხარჭოსნობა-ჲ	Besitz einer Nebenfrau
სიტყუამეტნობა-ჲ	Geschwätzigkeit
უმეტნობა-ჲ	Mäßigkeit
მებოსტნობა-ჲ	Gemüseanbau
თანაცნობა-ჲ	Verstehen, Erfahren
წინაცნობა-ჲ	Vorauserkennen, Vorausbegreifen
მეცნობა-ჲ	Verstehen, Begreifen; Verstehen, Begreifen
წინაჲთცნობა-ჲ	Vorauserkennen, Vorausempfinden
მართლცნობა-ჲ	richtiges Verstehen
წინაჲსწარცნობა-ჲ	Vorauserkennen, Vorauserfahren
მეღჳნობა-ჲ	Sauferei; Sauferei
უღჳნობა-ჲ	Verbot des Weintrinkens
უმჴნობა-ჲ	Furchtsamkeit, Feigheit; Furchtsamkeit, Feigheit
საღელვოობა-ჲ	Aufregung, Betrübnis
უღელვოობა-ჲ	Ruhe, Friedlichkeit
საღმრთოობა-ჲ	Göttlichkeit
სამღდელოობა-ჲ	Priesterschaft
უსამართლოობა-ჲ	Ungerechtigkeit; Ungerechtigkeit
საუფლოობა-ჲ	Göttlichkeit
მაღლოობა-ჲ	Hochmut; Hochmut
დაუსაბამოობა-ჲ	Anfangslosigkeit; Anfangslosigkeit
თანადაუსაბამოობა-ჲ	Anfangslosigkeit, Ewigkeit; Anfangslosigkeit, Ewigkeit
წუერგამოობა-ჲ	Bartsprießen, Reifwerden
უჟამოობა-ჲ	Unzeitigkeit, Ungelegenheit; Unzeitigkeit, Ungelegenheit
უნუგეშინისცემოობა-ჲ	Trostlosigkeit, Verzweiflung
უსაზომოობა-ჲ	Maßlosigkeit
უდაბნოობა-ჲ	Einöde, unbesiedelte Gegend; Einöde, unbesiedelte Gegend
უთნოობა-ჲ	Unreinheit, Abscheulichkeit
სასიკუდინოობა-ჲ	Todesgefahr, Tödlichkeit
უჩინოობა-ჲ	Unsichtbarkeit, Verborgenheit; Unsichtbarkeit, Verborgenheit
საუკუნოობა-ჲ	ewiges Leben, Ewigkeit; ewiges Leben, Ewigkeit
უმჴნოობა-ჲ	Furchtsamkeit, Feigheit
უცხედროობა-ჲ	Wachsamkeit, Ungebettetheit
საჭიროობა-ჲ	Notwendigkeit; Notwendigkeit
სასოობა-ჲ	Hoffnung; Hoffnung
სამარადისოობა-ჲ	Ewigkeit; Ewigkeit
სამეუფოობა-ჲ	Königshof
პირმშოობა-ჲ	Erstgeburt; Erstgeburt
უანდერძოობა-ჲ	Testamentslosigkeit
ოთხკერძოობა-ჲ	Viereckigkeit
ზუხოობა-ჲ	Fröhlichkeit
სწორპატიჟობა-ჲ	gleiche Bestrafung
მომკუდარობა-ჲ	Tod, Sterben
შემხედვარობა-ჲ	Hoffnung
სატკივარობა-ჲ	Schmerz
უტკივარობა-ჲ	fehlendes Mitleid
მტყუვარობა-ჲ	Lügen
სიტყუამტყუვარობა-ჲ	Lüge
უზარობა-ჲ	Fleiß
ესევითარობა-ჲ	solche Art
ზიარობა-ჲ	Teilnahme, Anteilnahme, Gleichheit, Gleichgesonnenheit, Teilnahme; Teilnahme, Anteilnahme, Gleichheit, Gleichgesonnenheit, Teilnahme an der hl. Kommunion / am hl. Abendmahl
დევტალარობა-ჲ	Amt des Stellvertreters des Leiters / Bischofs / Abts
მომყმარობა-ჲ	Hunger
საჴმარობა-ჲ	Verwenden, Brauchen
მოცინარობა-ჲ	Lachen; Lachen
სტუმართმოყუარობა-ჲ	Gastfreundschaft; Gastfreundschaft
შემწუარობა-ჲ	Verbranntheit
მყეფარობა-ჲ	Bellen
მოფიცარობა-ჲ	Meineidschwören
თანამოფიცარობა-ჲ	Sichverschwören
ნებისაებრობა-ჲ	Willkür
ძალისაებრობა-ჲ	Vermögen, Imstandesein
სხუებრობა-ჲ	Unterschied, Verschiedenheit
ცუდადმზუაობრობა-ჲ	Hochmut, Stolz
თანამჴედრობა-ჲ	Kampfgefährtenschaft
მდიდრობა-ჲ	Reichtum; Reichtum
თანამკჳდრობა-ჲ	Zusammenleben, Beischlaf
საერობა-ჲ	Staatskasse
მშჳნვიერობა-ჲ	Atmen
ნივთიერობა-ჲ	Materialität; Materialität
ღმრთისამიერობა-ჲ	Göttlichkeit
ზომიერობა-ჲ	Mäßigkeit; Mäßigkeit
საქმიერობა-ჲ	Eigentumsklage
პირშუენიერობა-ჲ	Schönheit; Schönheit
ქონიერობა-ჲ	Besitz, Habe, Reichtum; Besitz, Habe, Reichtum
წესიერობა-ჲ	Ordnung, Reihenfolge, Gesetzlichkeit
მაქუსიერობა-ჲ	Besitz, Habe, Reichtum; Besitz, Habe, Reichtum
მტიერობა-ჲ	Glatzköpfigkeit
ნაყოფიერობა-ჲ	Fruchtbarkeit; Fruchtbarkeit
თითოფერობა-ჲ	Unterschiedlichkeit; Unterschiedlichkeit
ცეცხლისფერობა-ჲ	Röte
მწუანისფერობა-ჲ	Grün
ოქროჲსფერობა-ჲ	Goldfarbe
ქუეყანითმომღერობა-ჲ	Wahrsagen aus der Erde
სიტყჳერობა-ჲ	Reden, Redekunst, Sprache; Reden, Redekunst, Sprache
მეოთხედმთავრობა-ჲ	Tetrarchie
მამათმთავრობა-ჲ	Erzbischofsamt
ღმერთმთავრობა-ჲ	göttliche Macht
უმშჯავრობა-ჲ	Ungerechtigkeit; Ungerechtigkeit
მრავალბევრობა-ჲ	Vielzahl, Menge
მოუქცევრობა-ჲ	Unumkehrbarkeit
მრავალნაწევრობა-ჲ	Festigkeit
სიტყუამჭევრობა-ჲ	Redekunst, Rhetorik
მტყუვრობა-ჲ	Lügen; Lügen
უსაზღვრობა-ჲ	Grenzenlosigkeit; Grenzenlosigkeit
თეთრობა-ჲ	weiße Farbe
საკუთრობა-ჲ	Zugehörigkeit, Eigenschaft; Zugehörigkeit, Eigenschaft
ქველპირობა-ჲ	guter Rat
პირისპირობა-ჲ	Unmittelbarkeit
სიტყუადუხჭირობა-ჲ	Lästerung
პადიმრობა-ჲ	Gefangennahme
საჴმრობა-ჲ	Bedarf
ჰავმოისრობა-ჲ	Fehlschießen mit dem Pfeil
მონასტრობა-ჲ	Klosterleben
მსტრობა-ჲ	Beobachten, Spähen, Spionieren; Beobachten, Spähen, Spionieren
მესძეურობა-ჲ	Säugen
მეთევზურობა-ჲ	Fischfang
სოფლურობა-ჲ	Weltlichkeit, Irdischkeit, Leben auf nichtkirchliche Art
გარემეღამურობა-ჲ	übernachten im Freien
თანამოსუმურობა-ჲ	Fest, Zecherei, Gelage
საზეპურობა-ჲ	Erlesenheit
ზედამსტურობა-ჲ	Aufsicht
ტყირბისმსტურობა-ჲ	Wahrsagerei aus der Leber, Eingeweideschau
ღჳძლისმსტურობა-ჲ	Leberschau, Leberorakel
მძღურობა-ჲ	Führung
მჴედართმძღურობა-ჲ	Feldherrenamt
წინამოძღურობა-ჲ	Führung
უმოძღურობა-ჲ	Lehrerlosigkeit
მემახურობა-ჲ	Fallenstellen, Heimtücke
მტკუეფრობა-ჲ	überziehen, Bedecken
უწინამძღრობა-ჲ	Lehrerlosigkeit, Führerlosigkeit
წინადაპყრობა-ჲ	Besitz, Herrschaft
ჴელაპყრობა-ჲ	Erheben der Hände
ჴელისაპყრობა-ჲ	Hilfe, Unterstützung
ჴელითპყრობა-ჲ	Führung mit der Hand
აღჳრთპყრობა-ჲ	Führen, Leiten
ყურისმიპყრობა-ჲ	Anhören
ჴელპყრობა-ჲ	Anfassen, Helfen
მისწრობა-ჲ	rechtzeitiges Hingelangen
მარტჳრობა-ჲ	Martyrium; Martyrium
უაღჳრობა-ჲ	Zügellosigkeit
უსაყოველთაესობა-ჲ	größte Allgemeinheit
უცხადესობა-ჲ	große Klarheit
უდიდესობა-ჲ	Mehrheit, Führung, führende Größe
უწმიდესობა-ჲ	größte Reinheit
უნარჩევესობა-ჲ	schlechteste Situation
უმდაბლესობა-ჲ	äußerste Kleinheit
უმახლობელესობა-ჲ	äußerstes Nahestehen
უპირველესობა-ჲ	frühere Existenz
უსასურველესობა-ჲ	äußerste Erwünschtheit
უუცთომელესობა-ჲ	größte Wahrheit
უსაშინელესობა-ჲ	äußerste Gefahr
უძუელესობა-ჲ	hohes Alter
უტკბილესობა-ჲ	starke Süße
უგანგრძობილესობა-ჲ	längere Dauer
უადვილესობა-ჲ	Leichtigkeit
უწარჩინებულესობა-ჲ	herausragende Größe
უსრულესობა-ჲ	Vollständigkeit, Vollkommenheit
უმკჳრცხლესობა-ჲ	äußerste Schnelligkeit
უმრწემესობა-ჲ	Jüngersein, Gehorsam
უმძიმესობა-ჲ	äußerste Schwierigkeit, äußerste Grausamkeit
უნაკლულევანესობა-ჲ	schlechtere Lage
უგულსმოდგინესობა-ჲ	höchste Bereitwilligkeit
უმოლხინესობა-ჲ	äußerste Besserung
უპატიოსნესობა-ჲ	überaus große Kostbarkeit / Verehrungswürdigkeit
უსაღმრთოესობა-ჲ	überaus große Heiligkeit
უსაჩინოესობა-ჲ	Deutlichkeit, Klarheit
უდარესობა-ჲ	Geringheit, Minderheit
უკაცთმოყუარესობა-ჲ	überaus große Menschenfreundlichkeit
უძლიერესობა-ჲ	übergroße Stärke
უმძლავრესობა-ჲ	äußerste Stärke
უსაკუთრესობა-ჲ	Erlesenheit
უფროჲს-უმცირესობა-ჲ	Mehr- oder Minderheit
უუძლურესობა-ჲ	überaus große Schwäche
უმოძღურესობა-ჲ	äußerste Klugheit
უჭეშმარიტესობა-ჲ	größte Wahrheit
უსუბუქესობა-ჲ	Leichtigkeit, Leichtheit
დღესობა-ჲ	heutige Zeit, Moderne
უბილწესობა-ჲ	Unreinheit, große Verworfenheit
სამარადისობა-ჲ	Ewigkeit
მთავარმამასახლისობა-ჲ	Amt des Oberabts
საჭურისობა-ჲ	Eunuchentum
დიდფასისობა-ჲ	Teuerung, Teuerkeit
ენკრატისობა-ჲ	Nonnentum
პოტირიტისობა-ჲ	Vertretung
კომსობა-ჲ	Dienst am Königshof und für den Staat
სჳნკლიტიკოსობა-ჲ	Amt eines Senatsmitglieds
მიმოსობა-ჲ	Mimen, Nachahmen
ებისკოპოსობა-ჲ	Bischofsamt; Bischofsamt
მთავარებისკოპოსობა-ჲ	Amt des Erzbischofs; Amt des Erzbischofs
საეპისკოპოსობა-ჲ	Bischofsstadt, Bistum
მაგისტროსობა-ჲ	Würde des Magistros
ეპარხოსობა-ჲ	Stellvertretung des Königs
თანაარსობა-ჲ	Ewigkeit, Einheit
კეთილარსობა-ჲ	geordnetes Leben, ordentliches Leben
უარსობა-ჲ	Nichtexistenz
ღირსობა-ჲ	Würde, Ehre; Würde, Ehre
ხუცსობა-ჲ	Priesterschaft
უმოლხინჱსობა-ჲ	äußerste Besserung
პეტობა-ჲ	Fürstenamt
დრკუობა-ჲ	Heimtücke
წყლტუობა-ჲ	Kahlköpfigkeit
უიეფობა-ჲ	Unbilligkeit
თანამყოფობა-ჲ	Zusammenleben, Unterstützen; Zusammenleben, Unterstützen
მოწფობა-ჲ	Schülersein
პატრეაქობა-ჲ	Patriarchenamt
დედაქალაქობა-ჲ	Hauptstadt, Hauptstadtstatus
ქსენადოქობა-ჲ	Herbergsleitung
ქსენადუქობა-ჲ	Herbergsleitung; Herbergsleitung
უულვაშობა-ჲ	Schnurrbartlosigkeit
ფარაშობა-ჲ	Hausdienst
შამუშობა-ჲ	Erregung, Aufregung
სრულმამაკაცობა-ჲ	Mannesreife
მრავალკაცობა-ჲ	Friedhof
ნატაცობა-ჲ	Rauben, Entführen
სამკეცობა-ჲ	Dreifachheit
ორკეცობა-ჲ	Verdoppelung, Schwanken
ლეყეცობა-ჲ	Streit
ფიცობა-ჲ	Schwören; Schwören
ცილფიცობა-ჲ	Schwören eines Meineids; Schwören eines Meineids
ცრუფიცობა-ჲ	Schwören eines Meineids; Schwören eines Meineids
ერთჴორცობა-ჲ	Einigkeit, Einheit
ცილფუცობა-ჲ	Schwören eines Meineids
უღუაწობა-ჲ	Verwahrlosung, Mangel, Armut
ლირწობა-ჲ	Unreinheit, Unordentlichkeit
ჭელჭობა-ჲ	Sparsamkeit, Geiz
მომზრახობა-ჲ	Reden, Sprechen; Reden, Sprechen
ცუდმოზრახობა-ჲ	Lügen
პასუხობა-ჲ	Antworten
მზაპასუხობა-ჲ	Etymologie
ურიცხობა-ჲ	Unzähligkeit; Unzähligkeit
მორცხობა-ჲ	Schüchternheit
უმარჯობა-ჲ	Ungeschicklichkeit; Ungeschicklichkeit
თანასრბა-ჲ	Begleiten
წინასრბა-ჲ	überholen, zu frühes Kommen
მისრბა-ჲ	Hinrennen
მოსრბა-ჲ	Herrennen, Herlaufen
თანაწარსრბა-ჲ	Vorbeirennen, Vorüberrennen
წუმწუბა-ჲ	Schwefel; Schwefel
ერთკერძო-ჲ და-ჲ	Halbschwester
ველისზედა-ჲ	Nomade
ნაფურცლისზედა-ჲ	Traubenpflückrest
დაჭედა-ჲ	Schmieden
ფერწმიდა-ჲ	von reiner Farbe
ჴორცწმიდა-ჲ	angenehm, mit reiner Haut
განსყიდა-ჲ	Verkaufen
პატიჟის-მიჴდა-ჲ	Bestrafen
სიტყჳს-მიჴდა-ჲ	Rechenschaftslegung
სესხის მოჴდა-ჲ	Zurückforderung geliehenen Geldes
თანაწარჴდა-ჲ	Sichvomhalsschaffen
ვა-ჲ	Weh
კუებვა-ჲ	Ernährung
ზედხედვა-ჲ	Aussehen, Anblick
ზედამიხედვა-ჲ	Nachsehen, Beaufsichtigen
უკუნზიდვა-ჲ	Zurückziehen, Zurückzerren
მისყიდვა-ჲ	Verkauf
მშჳლდვა-ჲ	Schießen mit Pfeil und Bogen
სარბევა-ჲ	Laufen, Rennen
მოკუმევა-ჲ	Beweihräuchern
შესუმევა-ჲ	Trinkenlassen, Tränken
მიმოგანბნევა-ჲ	Verstreuen
ქმნევა-ჲ	Machenlassen
შეცურევა-ჲ	Abkühlung
მოცურევა-ჲ	Pflücken, Sammeln
თანააღრევა-ჲ	Vermischen
ღრღუევა-ჲ	Zerstören
წინააღრჩევა-ჲ	Auslese, Auswahl
კუალადქცევა-ჲ	Umwendung, Zurückwendung
კეთილადქცევა-ჲ	Schnelligkeit
უკუანქცევა-ჲ	Rückkehr
უკუნქცევა-ჲ	Zurückkehren, Zurückschicken, Zurückgeben, Zurückweichen
ზურგუკუნქცევა-ჲ	Umdrehen, Umkehr
ზურგუკუქცევა-ჲ	Umdrehen, Umkehr, Zuwenden des Rückens
გამოძევა-ჲ	Untersuchen, Herausfinden, Ermitteln
საკურთხევა-ჲ	Segnen
თანაშეთხზვა-ჲ	Vereinen
აღშფოთვა-ჲ	Empörung, Erregung
წინაგანმართვა-ჲ	Belehrung
პურისრთვა-ჲ	Einladen
მიდამომალვა-ჲ	Sichverstecken an verschiedenen Orten
ჩათუალვა-ჲ	Zählen
შემშჭუალვა-ჲ	Verbinden, Verknüpfen, Durchdringen
ნათლვა-ჲ	Taufen
თანახილვა-ჲ	Sehen, Erblicken
ზეგარდამოხილვა-ჲ	Herabblicken
ძჳრისხილვა-ჲ	Bosheit
გემოჲსხილვა-ჲ	Kosten, Essen
ზეაღხილვა-ჲ	Hinaufsehen, Emporsehen
კაცის-კლვა-ჲ	Töten, Mord
წამლვა-ჲ	Vergiften, Verzaubern
მიწდოლვა-ჲ	Verstehen
შელტოლვა-ჲ	Hineinrennen, Zufluchtsuchen
მივლტოლვა-ჲ	Flucht
განვლტოლვა-ჲ	Entfliehen, Flucht
მოლტოლვა-ჲ	rasches Herkommen, Sichaufdrängen
მსხუერპლვა-ჲ	Opfern
გზის-სლვა-ჲ	Reisen
ზედამოსლვა-ჲ	Kommen, Angreifen
თანაშთამოსლვა-ჲ	Herabkommen
უკმოსლვა-ჲ	Rückkehr, Umkehr
ნავისსლვა-ჲ	Schiffahrt
მირულვა-ჲ	Einschlummern
ნავღულვა-ჲ	Erbitterung, Verbitterung
შერჩულვა-ჲ	Lehren, Unterrichten, Unterweisung
შეუღლვა-ჲ	Verbindung, Verknüpfung
მოკუფხლვა-ჲ	Pflücken
განკაზმვა-ჲ	Vorbereiten
ძღუანვა-ჲ	Wegsenden; Führen
წინაძღუანვა-ჲ	Führung
წარძღუანვა-ჲ	Begleitetwerden, Weggehen
წინაწარძღუანვა-ჲ	Führung
კუთნვა-ჲ	Einheit, Gruppe
ჟრუნვა-ჲ	Schaudern, Schauder
რჩუნვა-ჲ	Beschlagen, Verzieren
აღნიშნვა-ჲ	Bezeichnen, Bestimmen, Ernennen
მოზჳნვა-ჲ	rundherum Auftürmen
კრკჳნვა-ჲ	Fürsorge, Betreuung
დურტჳნვა-ჲ	Empörung, Unzufriedenheit, Aufruhr; Empörung, Unzufriedenheit, Aufruhr
მშჳნვა-ჲ	Atmen
მეგლოვა-ჲ	Trauer
ქედმაღლოვა-ჲ	Hochmut
მოქუსოვა-ჲ	Weben; Weben
მიმოდათხოვა-ჲ	Bitten, Flehen, Fürsorge
განთხოვა-ჲ	Heiraten (von der Frau), Verheiraten (einer Frau)
მოზოპვა-ჲ	Prahlen, Lügen
ჰაზრვა-ჲ	Hellsehen, Wahrsagen
შეზუმირვა-ჲ	Einreiben mit Myrrhe
ჟამისწირვა-ჲ	Gottesdienst, Messe
ჰამრვა-ჲ	Zählung, Rechnung
ძორვა-ჲ	Opfern
მიმოძრვა-ჲ	Schwanken
მიმოგანთესვა-ჲ	Verstreuen
ცეცხლითმოწუვა-ჲ	Verbrennen im Feuer
წისქჳლისქვა-ჲ	Mühlstein
უკუზღვა-ჲ	Bezahlung, Entgelt, Vergütung
შერწყვა-ჲ	Verbinden, Vereinen
წინაცვა-ჲ	Wachen, Bewachen
მოძრცვა-ჲ	Abnehmen, Ausziehen, Wegnehmen; Abnehmen, Ausziehen, Wegnehmen
ეჭვა-ჲ	Zweifel, Argwohn; Zweifel, Argwohn
მოზრახვა-ჲ	Schwätzen, Quatschen
ძჳრისზრახვა-ჲ	Lästern
სახისგამოსახვა-ჲ	Ausdrücken, Gleichnis
წიგნისკითხვა-ჲ	Lesen, Lesen und Schreiben
შაჰვა-ჲ	Huren
ღჳვა-ჲ	Wacholder
ტყჳვა-ჲ	Blei; Blei
სადილობისა გზა-ჲ	vom Morgen bis zum Frühstück zurückzulegender Weg
ჩუეულება-ჲ დედათა-ჲ	Menstruation
მჭევრობა-ჲ სიტყუათა-ჲ	Redekunst
გარდასრულობა-ჲ დღეთა-ჲ	Alter
მიდგმა-ჲ თუალთა-ჲ	Ansehen
იგია-ჲ	sie (eine Frau)
ჯერაკუმია-ჲ	Altenheim
ლოღარია-ჲ	Berechnen
ექუსორია-ჲ	Vertreibung, Austreibung, Verbannung; Vertreibung, Austreibung, Verbannung
მოღუაწია-ჲ	Arbeiterin, Schaffende, Wirkende, Fürsorgende, Nonne
ურვილაკა-ჲ	armer Tropf
მუჴლთდრეკა-ჲ	Niederknien
მუჴლდრეკა-ჲ	Niederknien; Niederknien
ქუემოდრეკა-ჲ	Unterwürfigkeit
მუჴლთმოდრეკა-ჲ	Niederknien
მიმოდრეკა-ჲ	Hin- und Herbiegen
ფუვინკა-ჲ	ein Vogel
აპკა-ჲ	Haut, Schale
უბადრუკა-ჲ	Armseliger
მჴევალა-ჲ	Dienerin, Magd, Sklavin
უფალა-ჲ	Frau, Königin
ფათილა-ჲ	eine Arznei
კაპილა-ჲ	Laden, Schenke; Inhaber eines Ladens / einer Schenke
ნაწილა-ჲ	kleiner Teil
ლაკლა-ჲ	Brett, Teller, Schüssel, Schale
მიმოსრბოლა-ჲ	Hin- und Herrennen, Geschäftigkeit
სივტოლა-ჲ	Fliehen, Flucht; Fliehen, Flucht
თანამიყოლა-ჲ	Folgen
თანაშთამოყოლა-ჲ	Herabbegleiten
თანააღყოლა-ჲ	Folgen, Hinauffolgen, Nachtun
თანამიწოლა-ჲ	Sichhinlegen
სხოლა-ჲ	Leibgarde des Kaisers
სიკრულა-ჲ	Wahrsagevorrichtung
ქათამა-ჲ	kleines Huhn
დედა-მამა-ჲ	Eltern
ნათლისმამა-ჲ	Taufpate
პურისჭამა-ჲ	Essen, Speisen
ინაჴის-დგმა-ჲ	Decken der Tafel
თუალთმიდგმა-ჲ	Ansehen, Blicken
ჴელისგანდგმა-ჲ	Verrichten, Tätigkeit
ლაშქრისმოდგმა-ჲ	Umzingeln, Belagern
კარვისდგმა-ჲ	Zeltaufstellen, Fest des Zeltaufstellens
დაგუემა-ჲ	Schlagen, Quälen
თავყანის-ცემა-ჲ	Verehrung
თანანუგეშინის-ცემა-ჲ	Mitfühlen, Trösten
ცხჳრ-დაცემა-ჲ	Niesen
ცხჳრის-დაცემა-ჲ	Niesen
ჴელითდაცემა-ჲ	Onanie
თანაწარცემა-ჲ	Schicken, Senden
რიმა-ჲ	Wort
წინადადგომა-ჲ	Widerstand, Kampf
ზედადგომა-ჲ	Leiten
ზედააღდგომა-ჲ	Widerstand
წინააღდგომა-ჲ	Widerstand
ზეაღდგომა-ჲ	Aufstehen
დადრგომა-ჲ	Stehenbleiben, Haltmachen
წარმოვრდომა-ჲ	Geschehen, Machen
თანადახუდომა-ჲ	Antreffen, Einwilligen
ზეშთაჯდომა-ჲ	Vorsitzen, Vorsitz
წინაჯდომა-ჲ	Vorsitz
პირველადჯდომა-ჲ	Sitzen am Ehrenplatz
პირველჯდომა-ჲ	Vorsitzen, Leiten
ზემოჯდომა-ჲ	Obensitzen, Vornsitzen, Vorsitz
შეზომა-ჲ	Vergleich
ქუეყანისგანზომა-ჲ	Geometrie
წარმოცთომა-ჲ	Verführen, Verleiten, Verfehlen
დგრომა-ჲ	Stehen, Stehenbleiben, Haltmachen
განზღომა-ჲ	Sattwerden
განვრცომა-ჲ	Verbreitung, Ausbreitung
დამჴომა-ჲ	Niederfallen, Niederstürzen
თერმა-ჲ	Geldersatz
სულთ-თქუმა-ჲ	Stöhnen, Betrübnis
გამოთქუმა-ჲ	Aussprechen; Erzählen, Erklärung
უკუთქუმა-ჲ	Verneinen
თანაშერწყუმა-ჲ	Vereinen, Verbinden
ცუმა-ჲ	Anziehen, Kleiden
ჩამოხუმა-ჲ	Herabnehmen
დედისძმა-ჲ	Onkel (Bruder der Mutter)
ზედადასხმა-ჲ	Legen, Verwunden
შუაჴმა-ჲ	mit maßvoller Stimme
ორჴმა-ჲ	zweierlei Ansicht / Meinung
მათთანა-ჲ	ein bei ihnen Befindlicher
იესუსთანა-ჲ	Anhänger Jesus
თჳსთანა-ჲ	ein ihm Nahestehender
მოქრისტიანა-ჲ	Christin
დატკებნა-ჲ	Stampfen
ცებნა-ჲ	Wissen
წიგნა-ჲ	Büchlein
ზედადადგენა-ჲ	Festsetzen, Anordnen
მიმოგანფენა-ჲ	Verbreitung
უკურჩენა-ჲ	Gewinn, Profit
ღჭენა-ჲ	Knirschen; Knirschen
წარევნა-ჲ	Phantasieren, unklares Reden
შერევნა-ჲ	Vermischen, Vereinen, Durcheinanderbringen; Spaltung, Häresie; Vermischen, Vereinen, Durcheinanderbringen; Spaltung, Häresie
წუევნა-ჲ	Rufen, Einladen; Rufen, Einladen
დაწუევნა-ჲ	Einladen
ზედამიწევნა-ჲ	Verständnis, Weisheit
ვერწევნა-ჲ	Nichterreichenkönnen
კაც-პოვნა-ჲ	Erscheinen / Aussehen als Mensch
ვერპოვნა-ჲ	Nichtfindenkönnen
პლანინა-ჲ	Bergweide, Alpe
იერუსალჱმსშინა-ჲ	Jerusalemer
რღუნისწინა-ჲ	vor der Sintflut
ლაკნა-ჲ	Brett, Teller, Schüssel, Schale; Brett, Teller, Schüssel, Schale
სტამნა-ჲ	Krug; Krug
ჰავისზმნა-ჲ	Zaubern
მოშურნე-ქმნა-ჲ	Neid
მიზეზ-ქმნა-ჲ	Vorschützen, Vorgeben
კაცთ-ქმნა-ჲ	Erschaffung als Menschen
საკიცხელ-ქმნა-ჲ	Lächerlichmachen
უჟამო-ქმნა-ჲ	Unzeit, Ungelegenheit
უბიწო-ქმნა-ჲ	Reinigen, Läutern
პირ-ქმნა-ჲ	Machen, Tun
დასაწყის-ქმნა-ჲ	Beginnen
კაც-ქმნა-ჲ	Menschwerdung
თანამონა-ჲ	Mitbediensteter
უმოლხინესონა-ჲ	äußerste Besserung
ფსალმუნა-ჲ	Psalm
წყლითრღუნა-ჲ	Sintflut, Hochwasser
ხუეშნა-ჲ	Flehen, Gebet; Bote; Flehen, Gebet; Bote
მხალოა-ჲ	Speise aus grünem Gemüse
ქსოა-ჲ	Weben
გამოთხოა-ჲ	Bitten; Bitten
პურისთხოა-ჲ	Essenbetteln
გოსპა-ჲ	Kleidungsstück mit Fransen; Kleidungsstück mit Fransen
იადგარა-ჲ	Hymnensammlung; Gedenkschrift; Hymnensammlung; Gedenkschrift
მდიდარა-ჲ	reiche Frau
დიფთერა-ჲ	auf Pergament geschriebenes Buch
ჴელისწერა-ჲ	Geschriebenes, Inschrift, Festlegung
წიგნისწერა-ჲ	Schreiben
მანდრაღორა-ჲ	Alraune; Alraune
თერისტრა-ჲ	Kleidung
პურა-ჲ	kleines Brot
ჴნარცჳს-თხრა-ჲ	Aushebung einer Grube
გუერდისთხრა-ჲ	Zerstören der Seitenwand
შაჰრა-ჲ	Landstraße
გულისკუნესა-ჲ	Trauer
ნიგუზისა-ჲ	Nußschale
ქართველ-ი დასავალისა-ჲ	Bewohner der Pyrenäenhalbinsel, "Iberer des Westens"
მოქცევ-ი შჳდეულისა-ჲ	Woche
აღტჳრთვა-ჲ მუცლისა-ჲ	Schwangerschaft
შემამკობელ-ი სძლისა-ჲ	Trauzeuge
ტირისკნისა-ჲ	Monatsname (etwa November-Dezember)
სიმკაცრე-ჲ ლექსისა-ჲ	Grobheit, grobes Wort
მშჳლდ-ი ცისა-ჲ	Regenbogen
თჳთმიწისა-ჲ	Eingeborener
კოვზ-ი ზღჳსა-ჲ	Meeresschnecke
საქანელ-ი სიტყჳსა-ჲ	Redekunst
მრავალმოქცევობა-ჲ სიტყჳსა-ჲ	Redekunst, Rhetorik
ალელუა-ჲ	Halleluja
წინაგანსიტყუა-ჲ	Streiten
ოქროსიტყუა-ჲ	Redner, Orator
მრავლისსიტყუა-ჲ	Schwätzerei
ძჳრისსიტყუა-ჲ	Blasphemie
ხაჭუა-ჲ	Quark
დაკაფა-ჲ	Fällen, Roden
სწრაფა-ჲ	Wunsch, Streben
თანაყოფა-ჲ	Zusammensein, Beischlaf
წინაყოფა-ჲ	Hinstellen, Hinlegen, Geben, Schenken, Reichen, Erfüllen, Vollenden; Gleichnis
არაყოფა-ჲ	Nichtexistenz
ღმერთყოფა-ჲ	Vergöttlichung, Vergötterung
ჴელისმიყოფა-ჲ	Berührung
მიმოგანყოფა-ჲ	Teilen, Verteilen
აქა-ჲ	hiesig, Hiesiges
ზუზღა-ჲ	Eiter
ნაყა-ჲ	Zerstoßen, Zerstampfen
ბერტყა-ჲ	Schlagen, Schütteln, Ausklopfen
დამწყა-ჲ	Abrichten
სამცა-ჲ	dritter Himmel
აღჴოცა-ჲ	Vernichten
აღძურცა-ჲ	Ausziehen, Entfernen
მამისბიძა-ჲ	Onkel des Vaters
მეხისტეხა-ჲ	Donner, Donnerschlag
ტომის-რაცხა-ჲ	Volkszählung
ტოჰმის-რაცხა-ჲ	Volkszählung
აღრაცხა-ჲ	Zählen
მჯა-ჲ	Weizenstroh, Weizenhalme
თანშეშჯა-ჲ	Verbinden, Verknüpfen
მარვაჰა-ჲ	Korb
ალელუჲა-ჲ	Halleluja; Halleluja
კჳრიაე-ჲ	Sonntag; Sonntag
მესირაე-ჲ	Schilfflechter
სააფრაე-ჲ	Segeltuch
კჳრაე-ჲ	Sonntag; Sonntag
სადროშაე-ჲ	Fahnen-
სათიბე-ჲ	Heuwiese
საჴამლობე-ჲ	Schuhe
სილირბე-ჲ	Dreistheit, Unverschämtheit
მსრბე-ჲ	Läufer
სისადაგე-ჲ	Einfachheit, Gewöhnlichkeit
სასურმაგე-ჲ	Farbgefäß
საგუშაგე-ჲ	Wachturm, Leuchtturm
მენიჯოგე-ჲ	Speerträger, Waffenträger
მენერგე-ჲ	Gärtner
მდინარისკიდე-ჲ	Flußufer
საჴიდე-ჲ	Brückenzoll
კმოდე-ჲ	Felsklippe, Steilufer, Felssturz
ზღუდისზღუდე-ჲ	Mauer, Wall
პირისმწდე-ჲ	Mundschenk
თეე-ჲ	Raum der Tempelwächter; Raum der Tempelwächter
თანამენავე-ჲ	Mitreisender auf einem Schiff
შიშავე-ჲ	Schwärze; Schwärze
ალოვე-ჲ	Aloe; Aloe
მეარვე-ჲ	Hirt
მონათესვე-ჲ	Verwandter
სიდრკუვე-ჲ	Heimtücke; Heimtücke
მერუვე-ჲ	Kanalwärter
სიღრუვე-ჲ	öffnung, Loch; öffnung, Loch
სიცრუვე-ჲ	Lüge, Falschheit; Lüge, Falschheit
საასპარეზე-ჲ	Arena, Kampfplatz
მეასპარეზე-ჲ	Jockey
სამმზე-ჲ	Dreifaltigkeit
მეშაბათე-ჲ	Sabbatfeiernder
მებარბითე-ჲ	Harfenspieler
იაკინთე-ჲ	Hyazinth (Edelstein); kostbares Gewebe; Hyazinth (Edelstein); kostbares
ჳაკინთე-ჲ	Hyazinth (Edelstein); kostbares Gewebe
საევლოგიე-ჲ	Opfergefäß
სინოტიე-ჲ	Feuchtigkeit, Nässe
სივაკე-ჲ	Ebene, gerade Fläche
შაბათ-კჳრიაკე-ჲ	Samstag und Sonntag
ახალკჳრიაკე-ჲ	neue Woche
მოსენაკე-ჲ	Einsiedler, Mönch in einer Einsiedelei
მეურაკპარაკე-ჲ	Straßensteher
თანამოჰასაკე-ჲ	Gleichaltriger
მეპრატაკე-ჲ	Lederbearbeiter
მეჯაუკე-ჲ	Verschwörer
სიჭაპუკე-ჲ	Jugend; Jugend
ფრინვალე-ჲ	fliegend, Vogel; fliegend, Vogel
მფრინვალე-ჲ	fliegend, Vogel; fliegend, Vogel
მენაცვალე-ჲ	Ersatz, Erbe
ღმრთისმოლალე-ჲ	Feind Gottes
მეათძალე-ჲ	Spieler eines zehnsaitigen Instruments
სიობლე-ჲ	Waisentum, Verwaistheit
სიმგურგლე-ჲ	Kreis, Rundheit
საკანდლე-ჲ	Kerzenhalter
მენელსაცხებელე-ჲ	Spezereienzubereiter
ევანგელე-ჲ	Evangelium
მემფრინველე-ჲ	Wahrsager nach Vogelstimme und Vogelflug
თანმემსოფლელე-ჲ	Teilnehmer
მესათრომელე-ჲ	Netzfischer
მესურნელე-ჲ	Spezereienzubereiter
მეჭრელე-ჲ	Färber
საყელე-ჲ	Kragen
სიმკუეთლე-ჲ	Strenge, Schärfe
სილბილე-ჲ	Weichheit
სამპყრობილე-ჲ	Gefängnis; Gefängnis
თანამოსადილე-ჲ	Tischgenosse
მეაჩრდილე-ჲ	Schauspieler
საშვილე-ჲ	männliches Geschlechtsorgan
მექრთილე-ჲ	Gerstenanbauer
სიწულილე-ჲ	Winzigkeit
მესაჴუმილე-ჲ	Feueranzünder
სიორძილე-ჲ	Wachstum, Mehrung, Erhöhung
მეწინწილე-ჲ	Zymbelspieler
საუნჯაკლე-ჲ	Schatzkammer
წჳვმოკლე-ჲ	mit kurzem Unterschenkel
სილპოლე-ჲ	Fäulnis
კანონიან-ი ეპისტოლე-ჲ	offizielles Schreiben, Zeugnis
მემსხუერპლე-ჲ	Opferer
მექსლე-ჲ	Netzknüpfer
სიფუდულე-ჲ	Hochmut, Bosheit
თანამესახლეულე-ჲ	Familienmitglied
მეანეულე-ჲ	Pflüger
კეთილისმოძულე-ჲ	böser Mensch
ბოროტისმოძულე-ჲ	Verbrechenshasser
კაცისმოძულე-ჲ	Menschenhasser
თანამეუღლე-ჲ	Gatte, Gattin, Gesinnungsgenosse
თანამოსარჩლე-ჲ	Rechtsanwalt
თანამესარეცლე-ჲ	Gatte, Gattin
სიმჭლე-ჲ	Magerkeit
სასაწნეხლე-ჲ	Presse, Kelter
მემხლე-ჲ	Gemüsegärtner
მოსარჯლე-ჲ	Kläger, Rechtsanwalt; Kläger, Rechtsanwalt
ცუდმოწამე-ჲ	falscher Zeuge
პირველმოწამე-ჲ	erster Märtyrer
მთავარმოწამე-ჲ	großer Märtyrer
ქრისტესმოწამე-ჲ	Märtyrer
სიუზმე-ჲ	Hungern, Fasten
მელომე-ჲ	Löwendresseur
სააღნუმე-ჲ	Festplatz, Paradeplatz
საქალობელ-ი საქმე-ჲ	Verheiratetsein; Verheiratetsein
საქალობე-ჲ საქმე-ჲ	Verheiratetsein
ჴელთსაქმე-ჲ	Beruf
ქველისსაქმე-ჲ	Güte
ქუეყანისსაქმე-ჲ	Bodenbearbeitung
ძჳრისსაქმე-ჲ	böses Tun, Verbrechen
სიღმე-ჲ	Tiefe; Tiefe
სირღმე-ჲ	Tiefe; Tiefe
სალერწმე-ჲ	Schilfgegend
ქალბანე-ჲ	duftendes Baumharz, Galban; duftendes Baumharz, Galban
ქრისტეანე-ჲ	Christ
ადამანტიანე-ჲ	Diamant
ანდამანტიანე-ჲ	Diamant; Diamant
მეპანდუქიანე-ჲ	Gastwirt
მექუეყანე-ჲ	Einwohner, Bewohner
საოსტიგნე-ჲ	klösterlicher Vorratsraum
მეკაპილენე-ჲ	Ladenbesitzer; Ladenbesitzer
მარჯუენე-ჲ	rechter, Rechte; richtig, tüchtig
კაცთმოთნე-ჲ	Schmeichler
მოდგინე-ჲ	umzingelnd, Belagerer
სიკნინე-ჲ	Geringheit, Kleinheit
შიჩუკნე-ჲ	Faulheit, Feigheit, ängstlichkeit, Onanie; Faulheit, Feigheit, ängstlichkeit, Onanie
სადრაჰკნე-ჲ	Geldbeutel
ღჳნისმნე-ჲ	Oberkellermeister
მთავარღჳნისმნე-ჲ	Oberkellermeister
მეკაპილიონე-ჲ	Ladenbesitzer
ფილონე-ჲ	auf Pergament geschriebenes Gesetz des Mose
მეკანონე-ჲ	Gesetzeshüter, Gesetzestreuer
მეთეატრონე-ჲ	Schauspieler
მეღონე-ჲ	Helfer
ტაბერნე-ჲ	Gasthaus
მემისნე-ჲ	Hellseher
სამგოსნე-ჲ	Sänger-, Musikantenbühne
სიპატიოსნე-ჲ	Adel, Anstand
მეწუნე-ჲ	Koch, Suppenkoch
სიდაშნე-ჲ	Gutwilligkeit, Bescheidenheit
მეხუეიშნე-ჲ	Geheimnishüter; Geheimnishüter
მოხუაჲშნე-ჲ	Zuträger (einer Neuigkeit)
სიბძნე-ჲ	Weisheit; Weisheit
მოღჳნე-ჲ	Trunkenbold
სიურცხჳნე-ჲ	Unverschämtheit, Schamlosigkeit
სიფართოე-ჲ	Weite, Breite; Weite, Breite
მესაიდუმლოე-ჲ	Erfahrender
სიმარტოე-ჲ	Einsamkeit
თანმდებარე-ჲ	dabei befindlich, nahe seiend, Anhänger
გამომტკუეფლვარე-ჲ	Ausschlag
სიმცხინვარე-ჲ	Hitze
წინაშემდგომარე-ჲ	vorn stehend, Vorsteher
თანამჯდომარე-ჲ	dabeisitzend, Nächster
წინამჯდომარე-ჲ	Führer, Vorsitzender
შოვამდინარე-ჲ	Mesopotamien
შუამდინარე-ჲ	Mesopotamien
წუთხმდინარე-ჲ	mit herausfließendem Eiter
მექნარე-ჲ	Harfenspieler
დედათმოყუარე-ჲ	Frauenliebhaber
ნოვაგთმოყუარე-ჲ	Vielesser
სწავლულმოყუარე-ჲ	Philosoph
მთავრობისმოყუარე-ჲ	Machtgieriger, Karrierist
ცოდვისმოყუარე-ჲ	Sünder
შაჰვისმოყუარე-ჲ	Hurer
სასუმლისმოყუარე-ჲ	Trinker
ვეცხლისმოყუარე-ჲ	Geldliebhaber
სიბრძნისმოყუარე-ჲ	Philosoph
კაცისმოყუარე-ჲ	Menschenfreund
უდაბნოჲსმოყუარე-ჲ	Einsiedler, Asket
საჯუარე-ჲ	Kreuz-
სიადრე-ჲ	Schnelligkeit
სიშუენიერე-ჲ	Schönheit
მთავარმეზუერე-ჲ	Oberzöllner
უმთავრე-ჲ	hauptsächlich, Vorgesetzter; hauptsächlich, Vorgesetzter
სასაძოვრე-ჲ	Weide
საცხოვრე-ჲ	Viehhürde
მეჰაზრე-ჲ	Wahrsager, Lügner
სიზამთრე-ჲ	Bosheit
მენადირე-ჲ	Jäger; Jäger
სიყშირე-ჲ	Dichtheit, Dicke
თმამცირე-ჲ	mit spärlichem Haar
მემწირე-ჲ	Bediensteter im Gasthaus
მოშაჰირე-ჲ	Dichter
მოსტუმრე-ჲ	Gastgeber
ჴელთმოსაქმრე-ჲ	Handwerker
მეძმრე-ჲ	Essigverkäufer
სასაჴმრე-ჲ	Toilette
მუცლითმეზღაპრე-ჲ	Wahrsager
ტბურე-ჲ	kleiner See, Tümpel
მეუძლურე-ჲ	Krankenpfleger
მეჩქურე-ჲ	Schwätzer, Fasler, Dummredner
მემშურე-ჲ	Neider
პირველმთქრე-ჲ	überholend, Sieger
სივიწრე-ჲ	Enge; Enge
სავაჭრე-ჲ	zu verkaufend, Händlerware
საბანჯრე-ჲ	Tribut in Form von Weideland
მემჴრე-ჲ	auf einer Seite knieender Sänger bei der Liturgie
სიგუესე-ჲ	Heftigkeit, Schärfe
ურნატსავსე-ჲ	mit vollen Furchen
მეერგასისე-ჲ	fünfzigster; Pfingstfest
სიმყისე-ჲ	Plötzlichkeit
წინაკარსე-ჲ	Vortür
სიღირსე-ჲ	Würde
მესუეტე-ჲ	Stylites
უღლისმტე-ჲ	Verbündeter, Helfer
მეპურისმტე-ჲ	Tischgenosse
თანამეპურისმტე-ჲ	Tischgenosse
ძუძუჲსმტე-ჲ	Kind der Amme
მეპურისტე-ჲ	Tischgenosse; Tischgenosse
ცრუქრისტე-ჲ	falscher Christus
სიშლუე-ჲ	Kahlköpfigkeit
მერიცხუე-ჲ	Arithmetiker
მეკანაფე-ჲ	Seildreher
ზეშთჴელმწიფე-ჲ	himmlischer Herrscher
სინაზუქე-ჲ	Reinheit, Zartheit
მელიზღე-ჲ	Schwätzer
მეზედაშე-ჲ	Kellermeister
წინაშე-ჲ	Nahestehender
მათქუეშე-ჲ	ihr Untergebener, ihr Untertan
საშეშე-ჲ	Holz-
მრუშე-ჲ	Hurer, Hure
მექჳშე-ჲ	Kiesträger
მემჴეცე-ჲ	Abrichter von Raubtieren
სიორძე-ჲ	Wachstum, Mehrung
მენავეთმოღუაწე-ჲ	Steuermann
მჴეცთმოღუაწე-ჲ	Tierbändiger
მრავალმოღუაწე-ჲ	großer Schöpfer
უმოღუაწე-ჲ	ohne Diener
წინაბჭე-ჲ	Vortür
სანახე-ჲ	Gegend
წინასახე-ჲ	Zeichen, Urbild
მროწლისსახე-ჲ	Kupferapfel (dekoratives Detail)
მიოთხე-ჲ	vierter, Viertel; vierter, Viertel
საკუერთხე-ჲ	Opfergabe
სიმკჳრცხე-ჲ	Flottheit, Behendigkeit
ჰე-ჲ	Ja
სიმრღჳე-ჲ	Trübheit
საჰურიაო-ჲ	jüdisch, Juden-
კაბო-ჲ	Mehlmaß
სამაეგო-ჲ	Handels-, Laden
სიმინდო-ჲ	feinstes Weizenmehl; feinstes Weizenmehl
საარხონდო-ჲ	Fürstentum
უფრთეო-ჲ	flügellos; ohne Bögen / Gewölbe
სამეწუნეო-ჲ	Suppenzubereitung
სამოწესეო-ჲ	Kloster
სასაურავო-ჲ	Steuer, Abgabe
საკჳრავო-ჲ	Sonntags-
საზითვო-ჲ	Mitgift
უზითვო-ჲ	ohne Mitgift
საერისთვო-ჲ	an georg. Fürsten zu entrichtende Steuer
საციხისთვო-ჲ	eine Steuer
თანაიამვო-ჲ	Jambus
უნათესვო-ჲ	ohne Verwandte
თეზო-ჲ	Hüfte; Hüfte
სახარაბათო-ჲ	Ruine
იაკინთო-ჲ	Hyazinth (Edelstein); kostbares Gewebe; Hyazinth (Edelstein); kostbares
მდაბრიო-ჲ	Dörfler
უეკლესიო-ჲ	ohne Gemeinde
სოფიო-ჲ	Steinchen, Mosaik
მეოქროსოფიო-ჲ	Goldschmied, Juwelier
უმუშაკო-ჲ	untätig, ohne Arbeit
იანბიკო-ჲ	Jambus
საპარადოდიკო-ჲ	Steuerbuch, Steuerliste
კოდიკო-ჲ	Urkunde, Dokument, Gesetzeskodex
სახარკო-ჲ	Steuer, Abgabe
პეტალო-ჲ	blattförmiges Ornament; Blattgold; blattförmiges Ornament; Blattgold
ოქროპეტალო-ჲ	Blattgold
დასაყუდებელო-ჲ	Einsiedelei
უმახლობელო-ჲ	ohne Nahestehenden
საზრდელო-ჲ	Nahrung
სამზრდელო-ჲ	zu ernährend, zu speisend, Speisesaal
ობოლთსამზრდელო-ჲ	Waisenhaus
სამღრდელო-ჲ	Priester-, Kirche; Priester-, Kirche
სამკლველო-ჲ	zu tötend, Todes-
სამურკნველო-ჲ	zu reinigend, Reinigungs-
სულთსამზრუნველო-ჲ	Zuflucht
კრულთსამცველო-ჲ	Gefängnis
უმუსიკელო-ჲ	unmusikalisch, ohne Melodie
საწინაჲსწარმეტყუელო-ჲ	Propheten-, Bücher der Propheten; Propheten-,; Propheten-,
სამონათლო-ჲ	Taufbecken
საპყრობილო-ჲ	Gefängnis
ჩდილო-ჲ	Schatten, schattiger Ort, Norden; Schatten, schattiger Ort, Norden
სამრემლო-ჲ	Gemeinde
საკარაულო-ჲ	Maultierhürde
უშჩულო-ჲ	ungläubig, gesetzlos, Missetäter; ungläubig, gesetzlos, Missetäter
სიწულო-ჲ	Winzigkeit
საჴევისუფლო-ჲ	Talgemeindesteuer
კოხლო-ჲ	Schnecke; Vorrichtung zum Knochenbrechen
მონოქსჳლო-ჲ	Einbaum; Einbaum
სამარტჳლო-ჲ	Märtyrergedenkstätte; Märtyrergedenkstätte
ფრთეგამო-ჲ	mit frischgewachsenen Flügeln
ფამო-ჲ	Verleumdungsschreiben
პურის-გემო-ჲ	Essen
ჰორმო-ჲ	Grube, Höhle; Grube, Höhle
უმოწმო-ჲ	ohne Aufsicht
საქუეყანო-ჲ	Weltgegend
სამონაზნო-ჲ	Mönchs-, Nonnen-; Mönchs-, Nonnen-
კჳკინო-ჲ	Schwan; Schwan
საკაპილიონო-ჲ	Laden, Geschäft, Handels-
საპანდუქიონო-ჲ	Gasthaus, Herberge
სათეატრონო-ჲ	Theatervorstellung
უხუაჲშნო-ჲ	verborgen, Geheimnis
ზეთ-ღჳნო-ჲ	öl und Wein
სასნეულო-საგლახაკო-საუცხოო-ჲ	Zufluchtsstätte der Siechen, Armen und Fremden
კანთარო-ჲ	Mistkäfer
უსაყდრო-ჲ	ohne Gemeinde, ohne Bistum
სამღდელთმთავრო-ჲ	Bischofs-
საზოლავრო-ჲ	Feldherren-
სამჯავრო-ჲ	Gericht; Gericht
სანაწევრო-ჲ	Glied, Körperteil
სააბეზრო-ჲ	Verbannungs-, Zufluchtsort
სამწირო-ჲ	Gasthaus
სასაქმრო-ჲ	Arbeit
უსჳნოღორო-ჲ	ohne Rechtsanwalt
ტიტრო-ჲ	Anordnung, Aufschrift; Anordnung, Aufschrift
ემპალასტრო-ჲ	Salbe
სამდგმურო-ჲ	Aufenthaltsort
სამღდელთმოძღურო-ჲ	Bischofs-, Bischofskirche
ჴელითხურო-ჲ	Zimmermann
საქონდაქრო-ჲ	Schlachthof
უწინამძღრო-ჲ	ohne Lehrer, ohne Führer
საფასო-ჲ	Preis, Lohn, Schatz, Besitz, Reichtum; Preis, Lohn, Schatz, Besitz, Reichtum
სასატრაპესო-ჲ	Satrapie
ამეთისო-ჲ	Amethyst; Amethyst
საერთისო-ჲ	Singular, Einzahl
საპარიკონომოსო-ჲ	eine Beamtenstelle im Kloster
საებისკოპოსო-ჲ	Bischofs-; Bischofs-
უეპისკოპოსო-ჲ	ohne Bischof
სამაგიროსო-ჲ	Kochgeschirr
საიპატოსო-ჲ	Fürsten-, Fürstenkleidung
უმოყუსო-ჲ	ohne Freunde
ამეთჳსო-ჲ	Amethyst
სალევიტო-ჲ	Leviten-
სამეტროპოლიტო-ჲ	Metropoliten-
ზაქო-ჲ	Hof; Gemach, Vorraum
საპატრიაქო-ჲ	Patriarchenamt
შაშო-ჲ	Gebärmutter, Schoß, Herkunftsland; Gebärmutter, Schoß, Herkunftsland
უშეშო-ჲ	nicht aus Holz
სამემრუშო-ჲ	Anklage wegen Hurerei
სიყშო-ჲ	Dicke
სიწლო-სიჴშო-ჲ	Winzigkeit und Dicke
სამრავალკაცო-ჲ	Gruft für mehrere Männer
თავისსაცო-ჲ	Kopfkissen
სივრცო-ჲ	Raum, Weite; Raum, Weite
მთითკერძო-ჲ	gebirgige Gegend
საღმრთოჲთკერძო-ჲ	göttlich, Gottes-
მილიონისკერძო-ჲ	Längenmaß (etwa 750 Schritte)
ღინჭო-ჲ	Kieselstein
საგანმზრახო-ჲ	Rat, Gericht
სიცხო-ჲ	Hitze, Fieber; Hitze, Fieber
უავაჯო-ჲ	ohne Melodie
