მიმოდასრბა	rasch verbreiten (Nachricht)
თანასრბა	begleiten, mitgehen
წინასრბა	überholen
შესრბა	hineinrennen
შინაშესრბა	hineineilen
მისრბა	hinrennen
მოსრბა	herrennen, herlaufen
მიმოსრბა	hin- und herrennen
წარსრბა	weglaufen, fliehen
თანაწარსრბა	vorbeirennen, vorüberrennen
წინწარსრბა	hineilen
შემოხადა	herbeirufen, einladen
შეწყუედა	schlagen
გასყიდა	verkaufen
განსყიდა	verkaufen
უკუმოსყიდა	auslösen, freikaufen
მოფრდა	kaufen
წარმოცდა	sehen
ზედამოჴდა	(Spreu) entfernen, reinigen
ზარჴდა	Furcht einflößen
თანაწარჴდა	sich vom Hals schaffen
ბრუმეტება თუალთა	blenden
დაწუართა	lernen, sich einprägen
მიმოდრეკა	hin- und herbiegen
შესხრეკა	biegen, beugen, krümmen
ჩაჩხრეკა	eintragen, einschreiben
შეჩხრეკა	eintragen, einsetzen, hinzufügen
მობღალა	besudeln, beschmieren
შეგლა	zerstampfen, zerquetschen
თანაშეზელა	sich einmischen
მიმოდავლა	hin- und hergehen
წინაწავლა	vorübergehen, vorbeigehen
წინაგანსწავლა	belehren
თხევლა	fischen
სათხევლა	fischen
გარემივლა	herumgehen
წიაღმოვლა	herüberkommen
თანაწარვლა	vorübergehen, vorbeigehen, mißachten
წიაღვლა	überschreiten
თანარბოლა	gemeinsam laufen
შევტოლა	hineinrennen, Zuflucht suchen
სივტოლა	fliehen; fliehen
შემოვლტოლა	hereinrennen, sich drinnen verbergen
წინაწარძღოლა	führen, vorangehen
გზა-ყოლა	begleiten
თანაყოლა	mitnehmen, mitbringen
თანაშეყოლა	sich einmischen, folgen
თანამიყოლა	folgen
შთამოყოლა	herabbegleiten
თანაშთამოყოლა	herabbegleiten
თანაწარყოლა	begleiten
ბძოლა	kämpfen, streiten, bekriegen; kämpfen, streiten, bekriegen
თანაბრძოლა	kämpfen, bekämpfen
უკუნსთულა	nochmals pflücken
თანაბმა	anbinden
ღაღად-დგმა	aufschreien
მიზეზის-დგმა	vorschützen, vorgeben, sich stellen
ინაჴის-დგმა	Tafel decken
წინადადგმა	aushalten
ზედგმა	daraufstehen
მიმოდგმა	andeuten
სრემა	kämmen, herrichten (Haar)
შთაგდებად-ცემა	hineinwerfen lassen, hinabwerfen lassen
წარდგინებად-ცემა	hinführen lassen
შეგბობად-ცემა	kochen lassen
აღქუმად-ცემა	brechen, übel sein, sich übergeben
მიწერად-ცემა	hinschreiben lassen
წარწერად-ცემა	unterschreiben lassen
შთაყოფად-ცემა	hineinstecken lassen
დაბრკოლების-ცემა	verführen, stören
შემატების-ცემა	hinzufügen, erwerben
დახრწევის-ცემა	stören
დასასრულის-ცემა	enden, beenden
თავყანის-ცემა	niederfallen vor, verehren, anbeten
შეწევნის-ცემა	helfen, unterstützen
პირის-ცემა	gestatten, erlauben
მიმოდაცემა	verteilen
ზეშთგარდაცემა	überlaufen
მადლის-მიცემა	danken
უკუნცემა	zurückgeben
ზედადადგომა	sich von oben hinstellen
წინადადგომა	Widerstand leisten, bekämpfen
ზედადგომა	leiten
თანამიდგომა	sich nähern
უკუნდგომა	zurückweichen, umkehren
ზედამოდგომა	kommen
მჴდომად აღდგომა	feind sein, befehden
ზედააღდგომა	Widerstand leisten
წინააღდგომა	Widerstand leisten, sich widersetzen
ზეაღდგომა	aufstehen
დადრგომა	stehenbleiben, haltmachen, bleiben, verbleiben, wohnen, einkehren; stehenbleiben, haltmachen, bleiben, verbleiben, wohnen, einkehren
შევდომა	niederfallen, niederknien, entgegenstürzen; niederfallen, niederknien, entgegenstürzen
შეხლდომა	aufspringen
უკუნვრდომა	auf die Rückseite fallen
შთამოვრდომა	herabfallen
გარდმოვრდომა	herabfallen, herunterfallen
შემოვრდომა	heranstürzen, begegnen
წარმოვრდომა	geschehen, machen
წარვრდომა	abfallen
გარდაწყუდომა	abreißen, aufhören
თანადახუდომა	anwesend sein, antreffen, einwilligen
სთქდომა	platzen, bersten, zerspringen
განსთქდომა	hervorbrechen, hervorquellen, herausstürzen, herausfallen; hervorbrechen, hervorquell
en, herausstürzen, herausfallen
განხთქდომა	hervorbrechen, hervorquellen, herausstürzen, herausfallen
გარდატყდომა	zermalmt werden
მიტყდომა	hinstürmen, hinstürzen
დაშდომა	bleiben, übrigbleiben, zurückbleiben, zurücklassen
ზესხდომა	oben sitzen
თანაჯდომა	zusammensitzen
ზეჯდომა	vorn sitzen, oben sitzen
წარმოჯდომა	sich aufsetzen
გადაჴდომა	hinübergehen, übertreten
ზედაგარდაჴდომა	überfluten, überschütten
გარდმოჴდომა	herabkommen, herüberkommen, herabsteigen,; herabkommen, herüberkommen, herabsteigen, niederstürzen
თანაწარმოჴდომა	herabkommen, vorübergehen
თანაწარჴდომა	abgenommen werden, vom Hals geschafft werden, vorübergehen
შეზომა	vergleichen
თანაშეზომა	passend / geeignet sein
განვლთომა	teilen, trennen, sich abteilen, sich überwerfen
წუთომა	versuchen
წარუკმოცთომა	sich irren
შთაძურომა	hineinkriechen
მიძურომა	hinkriechen
წარძურომა	wegkriechen
წათქრომა	überholen; überholen
წინაწათქრომა	überholen
წართქრომა	überholen
ქუეძრომა	kriechen
დაშრტომა	erlöschen
დაშტომა	erlöschen; erlöschen
განზღომა	satt werden
უკურჩომა	zurückbleiben
განვრცომა	verbreitet werden, sich ausbreiten
შემორთუმა	hereinbringen, übergeben
შებრკუმა	behindern, aufhalten, fehltreten
წარბრკუმა	sich irren, falsch machen
თანადასუმა	eng schreiben, Buchstaben an Buchstaben schreiben
მოსუმა	bestreichen, beschmieren
წარმოსუმა	aufsetzen
ქუმა	kleben, ankleben
სულთ-თქუმა	stöhnen, seufzen, betrübt sein
მოთქუმა	erzählen
გამოთქუმა	aussprechen; erzählen
ზემოწარმოთქუმა	oben erwähnen
ზემოწართქუმა	oben erwähnen
მორქუმა	beauftragen, ausrichten lassen
წარმოწყუმა	herausstoßen
უკუნცუმა	hinten hineinstoßen, hinten hineinspießen
მოცუმა	halten
ზემოცუმა	an die Oberfläche kommen
შეხუმა	hineintragen
უკუნხუმა	wieder heraufnehmen, zurückholen
ჩამოხუმა	Herabnehmen
შუვაწარმოხუმა	zeigen
თანაწარხუმა	wegnehmen, wegschaffen
შთათქმა	verschlingen; verschlingen
თანადშეჭმა	ganz aufessen
ძალ-სხმა	können, imstandesein
თავს-სხმა	auf sich nehmen, erdulden
მართჳს-სხმა	ausbrüten, Junge ausbrüten
ზედადასხმა	überfallen
წინადასხმა	hinlegen, geben, zeigen
უკუნსხმა	zurücklegen, nach hinten legen
უკუმოსხმა	ringsum anhäufen
დატკებნა	stampfen
ყმედნა	Atem anhalten
თანადცოდნა	wissen
მიმოთქრენა	drehen, wenden
თანაწარტყუენა	rauben, entführen
მიმოგანფენა	verbreiten
უკურჩენა	Gewinn machen, profitieren
ზედადაძენა	hinzufügen, mehren
ღჭენა	knirschen; knirschen
ფრჩხენა	zwicken; zwicken
შეფრჩხენა	kratzen, zerkratzen
მოფრჩხენა	kratzen, zerkratzen
ფრცხენა	zwicken
გარესგარედევნა	weit fortjagen, weit vertreiben
მიმოდევნა	verfolgt werden, verstreut werden
ძირგარევნა	peinigen, foltern
წარევნა	phantasieren, unsinnig reden
მოწუევნა	einladen
ზედამიწევნა	zu verstehen geben, verstehen
თნა	gefallen
შეთნა	gefallen; sich verlieben
ცუდ-ქმნა	als vergeblich betrachten
თავისუფალ-ქმნა	befreien
მლხინებელ-ქმნა	erleichtern
საძულელ-ქმნა	verhaßt machen
მეწამულ-ქმნა	rot färben, röten
ჴელცემულ-ქმნა	beginnen
უფერულ-ქმნა	farblos machen
გჳრგჳნოსან-ქმნა	krönen
უშვილო-ქმნა	kinderlos machen
უღონო-ქმნა	nicht imstande sein
მეგობარ-ქმნა	Freunde werden, sich befreunden
შვილიერ-ქმნა	mit Kind / Kindern versehend, kinderreich machend
კადნიერ-ქმნა	dreist machen, dreist werden lassen
ეკკლესიის-ქმნა	sich versammeln
კეთილის-ქმნა	Gutes tun
კსუ-ქმნა	derb / grob machen
პირუტყუ-ქმნა	zum Tier machen
მყოფ-ქმნა	(sich) ansiedeln, einbürgern
მოშიშ-ქმნა	verängstigen
შეურაცხ-ქმნა	mißachten
აქმნა	erbauen, machen, errichten; erbauen, machen, errichten
წინამოქმნა	im voraus bearbeiten
ჵსანნა	Hosianna; Hosianna
წარწმასნა	drehen, winden, zwirnen
მორღუნა	beträufeln, überschütten
შელიქნა	flehen, anflehen
განფურჩნა	sich entfalten, aufblühen
შემოხრწნა	Unreinheit verbreiten
განხწნა	verderben; verderben
განჴწნა	verderben; verderben
შეღულარჭნა	sich krümmen, sich winden
განწიხნა	einen Tritt geben
მოჭოხნა	zerkrümeln, zerbrechen
მოქსოა	weben; weben
შეჩხუეპა	hineinbohren, hineinstoßen
განჩხუეპა	schneiden, stechen
ზედაშემოწერა	umgrenzen, eingrenzen
მიმოდაყრა	umherstreuen
მიმოგანჭრა	schneiden, zerschneiden
მიმოჭრა	schwanken, hin- und herstürzen
მოდგომა გონებასა	zur Besinnung kommen
ჰამაპაჰასა	manchmal, bisweilen
თანაკუნესა	gemeinsam trauern
შედრესა	zermalmen
მიკრება ბრალისა	beschuldigen
აღშლა გულისა	erbrechen, übel sein
დაღება სულისა	sich beruhigen
მოდგმა სულისა	aufatmen, wieder zu sich kommen
ამოდგმა ენისა	zu sprechen beginnen
მიყოფა დღისა	Nacht anbrechen
მომწყსა	hüten, bewahren
წარმოდება სიტყჳსა	Rechenschaft ablegen
მატა	übertreiben, übersteigen
გამოგჳრტა	aufknospen
გამომკჳრტა	aufknospen
მოსიტყუა	erzählen
ზედაწარსიტყუა	hinzufügen, hinzusetzen (beim Reden)
ძჳრისსიტყუა	Blasphemie üben
ნეცუა	zerkrümeln, zermalmen
მიწრაფა	eilen, streben
სწრაფა	eilen, hasten, erstreben
შთასწრაფა	hinabeilen
შთამოსწრაფა	herabeilen
წარსწრაფა	forteilen
აღსწრაფა	sich beeilen, beschleunigen
პირისა დაყოფა	zum Schweigen bringen
თანაყოფა	zusammensein, beischlafen
წინაყოფა	hinstellen, hinlegen, geben, schenken, reichen, vollenden, erfüllen
თანაგანყოფა	sich befreunden
ხმაწა	zusammendrücken
თანაღუაწა	umsorgen, sich kümmern, betreuen
მოწნეხა	keltern, pressen
უკუმოკეცა	umblättern, umschlagen (von hinten nach vorn)
თანაშერაცხა	gelten, gezählt werden
აღრაცხა	zählen
ოფლება წერით	abschreiben, mühevoll abschreiben

დაქვაება	steinigen
ჰურიაება	ungläubig sein, dem jüdischen Glauben anhängen
ვალალაება	trauern, klagen
კმაება	genügen
წართანაება	hinzufügen
წინამიგებება	empfangen, begegnen
წინამოგებება	treffen, begegnen
შესულბება	sich fürchten, staunen, verblüfft sein
მშჳდობება	still sein, ruhig sein
მოღრუბება	bewölken
მწუბება	sich suhlen, sich beschmieren / bekleistern
ადგიდ-გება	festlegen, festsetzen, regeln, ordnen
სიტყჳს-გება	antworten, streiten
წინადაგება	decken, reichen, opfern
წინაქადაგება	prophezeien
განმაეგება	gewinnen
ზოგება	teilen
თავ-დება	auf sich nehmen, erdulden, ertragen; auf sich nehmen, erdulden, ertragen
გულს-დება	überlegen, beabsichtigen, betrübt sein
ზედადება	auf sich nehmen, sich verpflichtet fühlen; haben
წინამომზადება	vorbereiten
წინადება	vor sich haben
წუადება	sich räkeln
ზედაწუადება	herausnehmen, herausziehen
ღადება	schreien
წინაჲსწარღაღადება	prophezeien
წინაგამოცხადება	im voraus benachrichtigen
საცთურ-გდება	verführen, verleiten
ქუეწარგდება	niederwerfen
წინამორბედება	überholen
თანმოქმედება	gemeinsam handeln
ქველისმოქმედება	Barmherzigkeit üben
შორისმოქმედება	machen, tun, begehen
მიმიზდება	vermieten
თანადიდება	gemeinsam verherrlichen
ჩამაკიდება	aufhängen; aufhängen
სყიდება	verkauft werden
მისყიდება	sich verkaufen
გულდება	ermuntern
შეპალავანდება	(sich) belasten, bepacken
განწინდება	verpfänden
მილოდება	warten
თანაწარცოდება	sich vom Hals schaffen
წინაწოდება	rufen
უკმოწოდება	zurückrufen, zu sich rufen
უკუდება	hinter sich legen
დამრუდება	krümmen; zornig werden
პურისმტეება	gemeinsam essen
ქუეება	kleiner sein
მოსაფრჴეება	Falle stellen
თანაშეზავება	passend / geeignet sein
მისწავება	andeuten, anspielen
მიხედვება	ansehen lassen
განკიდევება	entfernen
შთამოტევება	herablassen
წარტევება	weglassen, freilassen, entlassen, angreifen
ტჳრთვება	aufnehmen lassen, wegnehmen lassen
მარჩბივება	Zwillinge gebären
ხილვება	untersuchen lassen
დასოლვება	naß machen
შესოლვება	naß machen; naß machen
გამოკუთნვება	aneignen, übereignen
მოფრინვება	herfliegen
გარეწარფრინვება	vorbeifliegen
განბწყინვება	glänzen
გამობწყინვება	hervorleuchten, hervorstrahlen,; hervorleuchten, hervorstrahlen, herausglänzen, zu strahlen beginnen, erstrahlen, aufleuchten
გასაჭიროვება	in Not sein
განუცხოვება	entfremden, abfallen, verraten
დაარვება	belästigen, plagen
თანაჭირვება	gemeinsam Not leiden, gemeinsam betrübt sein
შთაგორვება	hinabrollen
მიგორვება	hinrollen, hinwälzen
შეცურვება	hineintreiben lassen, hineinschwimmen lassen
შეგუვება	angewöhnen, anpassen; angewöhnen, anpassen
გამოღრუვება	durchlöchern, durchbohren
ცრუვება	lügen, belügen, täuschen, betrügen, schmähen; lügen, belügen, täuschen, betrügen, schmähen
განცრუვება	trügen, betrügen; trügen, betrügen
ნესტუვება	Schalmeienklängen zuhören lassen
განსიძვება	huren
ამრიზება	zürnen, wütend werden
შემონივთება	sammeln
მაგალითება	ähneln
შეჴელთება	in die Hände bekommen
მოჭედიება	beschlagen lassen
დაბეჭდიება	stempeln / versiegeln lassen
ქმნევიება	machen lassen
აღრჩევიება	wählen lassen
თაყუანის-ცემიება	verehren lassen
წერიება	schreiben lassen
დაწერიება	schreiben lassen
ეკლესიება	(sich) versammeln
შემოსიება	anziehen lassen
სიტყჳსგამოძიება	diskutieren
შემწიკება	beschmutzen, unrein machen, schänden
უბადრუკება	sich quälen
მიკაბალება	an sich reißen, sich aneignen
მომთრვალება	sich trunken geben, den Betrunkenen spielen
ნაცვალება	wechseln, ändern
მონაცვალება	wechseln, ändern
წაცვალება	sich verschieben
გარდამოცვალება	umwenden
მიმოცვალება	hin- und herbiegen, verändern
შთაძალება	zwingen
სიტყჳსმგებლება	antworten, streiten
დაჯოგლება	unbrauchbar werden, verderben, stumpf werden
დადედლება	feige / weibisch machen
საზრდელება	füttern, zu essen geben
მსოფლელება	nahe sein, benachbart sein
შუამდგომელება	vermitteln
შესურნელება	duften lassen, duftend machen
ტყუელება	Beifall klatschen
წინაწარმეტყუელება	prophezeien
წინაჲსწარმეტყუელება	prophezeien; prophezeien
მოგრძელება	lang werden, lang wachsen
სათხევლება	fischen
დაბრჯგუვლება	stumpf werden
წიაღვლება	hinüberzugehen zwingen, zum überschreiten zwingen, veranlassen hinüberzugehen
შეწულილება	Not leiden
შეფარილება	beschmutzen, besudeln
განძურცილება	entfernen
განმრავალწილება	vermehren
მრჩობლწილება	senken
მამლება	sich paaren (von Tieren)
წამლება	verzaubern, behexen
დაბკოლება	sich irren; stören; verführen; verärgert werden; sich irren; stören; verführen; verärgert werden
დაპკოლება	sich irren; stören; verführen; verärgert werden
სოლება	naß werden
განსოლება	hineinkeilen
თანაწარმოყოლება	herausbegleiten
თანაწარყოლება	mitgeben
თანამბრძოლება	im Kampf beistehen
ღმრთისმბრძოლება	gegen Gott kämpfen, Häretiker sein
ჴუებულება	fehlen, mangeln, abnehmen, schwinden
მიმოდაგულება	umhersehen, sich umsehen
მოსდულება	pflücken; pflücken
ბრალეულება	ein Verbrechen begehen
სახლეულება	zusammenleben
მრავალჟამეულება	lang andauern
დაზულება	auflösen, zerrütten, zerstören
მომსთულება	pflücken; pflücken
დამამულება	erben
შთამოსრულება	herabkommen
წამოსრულება	beenden, vollenden
მომაღლება	emporheben, hochziehen, sich heben
დაწრჳლება	dünn machen, verkleinern, zerstückeln; dünn machen, verkleinern,
შებრყჳლება	verführen, verleiten, fehlgehen, irren
მოქრთამება	bestechen
შეჭამება	aufessen lassen, verzehren lassen
ჰამება	angenehm sein, angenehm machen
მტკმება	öffnen
განცხრომება	verspotten, auslachen
დაყურჭუმება	tauchen
დაყმება	hungern
მოყმება	hungern, hungern lassen, verhungern, verhungern lassen
მოწმება	bezeugen, bestätigen
მოწჳმება	zu regnen beginnen
ამპარტავანება	hochmütig / stolz sein
ყვანება	wegbringen, fortbringen, weggehen
გაყვანება	hinausführen, wegführen, weglassen; hinausführen, wegführen, weglassen
მიმოდაყვანება	führen
თანაყვანება	hinführen, hinbringen
უკუნყვანება	zurückholen, zurückschicken
წინაგამოყვანება	herausführen
თანააღმოყვანება	heraufholen
წიაღმოყვანება	herüberholen
თანაწარყვანება	mitgeben, begleiten lassen
თანაშთატანება	herabbringen, herabschaffen
თანაწარტანება	mitnehmen
შეშუენება	passen, angemessen sein
წინაჩუენება	vorankündigen
წარმოცენება	herkommen, herauskommen
შემგზავნება	hineinschicken
თანამიდევნება	begleiten, folgen
ჰავჴელოვნება	Böses tun
მოპოვნება	finden, gewinnen, erwerben
გაგრუვნება	belügen
ცჳვნება	fallen
ჩაცჳვნება	hineinfallen; hineinwerfen
მოცჳვნება	herabfallen
დამოცჳვნება	herabfallen, herabstürzen
წარმოცჳვნება	herausfallen
დგინება	aufstellen, aufrichten, anordnen
კუალად-დგინება	aufstellen, festlegen
კუალს-დგინება	belehren
ზედადადგინება	festlegen, bestimmen, anordnen
შედგინება	hinstellen, hineinstellen
უკუნდგინება	von neuem festlegen, von neuem ernennen
წინააღდგინება	gegenüberstellen, hinstellen
გარდმოდინება	herablaufen, herabfließen; herablaufen, herabfließen
შემოდინება	hereinkommen, hereinfluten, sich versammeln
წარმოდინება	herbeifließen
თანაწარდინება	vorübergehen, vorbeigehen
შევლინება	hineinschicken, hinschicken
წამოვლინება	herschicken, absenden; herschicken, absenden
მიმოდარორინება	hin- und hergehen, reisen
მიმორორინება	hin- und herlaufen
მიმოფინება	verbreiten
აღმოტყინება	anzünden, anbrennen
პურად-ჩინება	zu einem Fest einladen
მძიმე-ჩინება	für schwer erachten / halten
მცირე-ჩინება	als gering betrachten
მარჯუე-ჩინება	für geeignet halten
ნამეტავ-ჩინება	als zuviel / überflüssig betrachten
საგინებელ-ჩინება	für schimpflich erachten
საგონებელ-ჩინება	für etwas halten
ფიცხელ-ჩინება	als streng / grausam ansehen
ტკბილ-ჩინება	lieben, als angenehm betrachten
განსაცემულ-ჩინება	als wegzugebend betrachten
სირცხჳლ-ჩინება	als schändlich betrachten
სათნო-ჩინება	gefallen, glauben
უჯერო-ჩინება	als unangemessen betrachten
საჭირო-ჩინება	als notwendig erachten
დაჭირვების-ჩინება	als bedürftig betrachten, für bedürftig halten
ჴუების-ჩინება	als wenig / vermindert betrachten
წუნობის-ჩინება	mißfallen, mißbilligen
ბასრობის-ჩინება	als lächerlich betrachten
ზედგამოჩინება	erscheinen
დღისა წარმოჩინება	Mittag sein / werden
მიჰრეონება	an sich reißen, sich aneignen; an sich reißen, sich aneignen
მოღონება	zustandebringen, bewerkstelligen, durch List erreichen
შეკურნება	heilen
მოსურნება	wollen, wünschen
მისნება	wahrsagen, vorhersagen
განქიტნება	zu Berge stehen, sich sträuben (Haar)
შემოლაზუნება	Mönch werden; Mönch werden
შემონაზუნება	Mönch werden
მიცთუნება	verführen, verleiten
წარმოცთუნება	belügen
თანაწარცთუნება	entfernen
სალმუნება	Psalter singen
მორწმუნება	gehorchen
ხჳშნება	flehen, bitten
ძნება	schwerfallen
მოსიბრძნება	auf seine Seite ziehen, verleiten, verführen, überzeugen, überlegen
ორძნება	wachsen
განორძნება	keimen, wachsen
აღმოცჱნება	sprießen, emporwachsen, treiben, wachsen, aufgehen, wachsen; sprießen, emporwachsen, treiben, wachsen, aufgehen, wachsen lassen
გარემოზჳნება	ringsum aufhäufen
შემოზჳნება	ringsum aufhäufen
რცხჳნება	beschämen, sich schämen
შერცხჳნება	sich schämen, beschämen
ურჩულოება	gesetzwidrig handeln
საჩინოება	sehen lassen, sichtbar sein, deutlich sein
ღონის-პოება	Gelegenheit / Mittel finden, versuchen
უკუნდროება	Zeit geben
თანაშედარება	passend sein / werden
თანაზიარება	teilnehmen
უპოარება	arm sein; arm sein
უარება	verneinen, leugnen
ტკივილთმოყუარება	mitfühlen, streben
შემცხუარება	braten, verbrennen
თანაგანხარება	sich gemeinsam freuen
დამწუხარება	erblinden
შეცჳბრება	sich wundern, staunen
მოვედრება	Zuflucht suchen / finden
თანადასაყდრება	gemeinsam einbürgern, gemeinsam niederlassen
მიმოდამკჳდრება	verstreuen
წარმომღერება	singen
თანაშენაწევრება	verbinden, verknüpfen
მომყოვრება	sich verspäten
შოვრება	entfernen, sich entfernen
მოშოვრება	entfernen, sich entfernen
შესაზღვრება	umgrenzen, eingrenzen
შემოსაზღვრება	umgrenzen, eingrenzen
მზირება	sehen, blicken
დამზირება	auflauern, beobachten
შეყშირება	sich verdicken, dicht werden, heftig werden; sich verdicken, dicht werden, heftig werden
სულისა შემცირება	Besinnung verlieren, ohnmächtig werden
ჩაკრება	hineinsammeln, hineinordnen; hineinsammeln, hineinordnen
წინაშემოკრება	im voraus versammeln
ზეაღმოკრება	herausnehmen, heraufnehmen
აღკრება	zusammenlegen, nehmen, sammeln
წიაღკრება	hinüberbringen, überholen
უცნაურება	nicht verstehen
მობადურება	fangen, auf seine Seite ziehen
სიჩქურება	eine Dummheit begehen
თქრება	galoppieren
დალაშქრება	Krieg führen, ins Feld ziehen
დაიწრება	bedrängen, belästigen, einengen, drücken
წინამისწრება	zuvorkommen
განცხრება	sich amüsieren
აღცხრება	begehren, wünschen
ანგაჰრება	gierig / habgierig sein
აღმოჭჳრება	aufgehen; erscheinen; aufleuchten
ნასება	schädigen
სოფლით აღვსება	sterben
თანაშეარსება	verbunden / vereint werden
მოყუსება	sich befreunden
შეკოლტება	sammeln, anhäufen
შეკერტება	anstarren
ქექუება	zu Pferde sitzen
თანაშეტყუება	entsprechen, anpassen
შეგულისსიტყუება	annehmen, glauben
ფუეშუება	sich tasten
წაჴუება	wegnehmen, entführen
განკაფება	abnutzen, verschließen, ermüden
შეწიფება	können
მოქალაქება	wirken
წარხეთქება	treten, stoßen, abreißen
წინამიღება	eher bekommen
უკუნღება	zurücknehmen
ნაყოფისგამოღება	Frucht bringen
აღმოდუღება	sprießen, emporwachsen
მჯუღება	packen, ergreifen, umklammern
გულისწყება	erzürnen
წინაუწყება	im voraus erfahren (lassen)
შეორკეცება	verdoppeln
შეტყორცება	werfen, schießen, hineinwerfen
განტყორცება	werfen, schleudern
შეფუცება	schwören lassen
მოგრძება	lang werden, lang wachsen
ღუაწება	fürsorgen, pflegen, wirken
ხარჭება	Nebenfrau werden, zur Nebenfrau machen
მზახება	anverwandt werden
ფრთხება	sich scheuen, sich fürchten, erschrecken
დაპოხება	fett machen, einfetten
შეჭუხება	betrübt werden
დაპატიჯება	einladen; einladen
ჰურიაობა	ungläubig sein, dem jüdischen Glauben anhängen; ungläubig sein, dem jüdischen Glauben anhängen
მზუელაობა	als Schauspieler auftreten, nachahmen
ორჴმაობა	verschiedener Meinung sein
დიდსიტყუაობა	lästern, verurteilen, rügen
უქმსიტყუაობა	unsinnig reden, schwätzen
მკაცრსიტყუაობა	grob reden, unflätig reden
მშჳდობობა	ruhig / friedlich sein
წბობა	schlürfen
აღწბობა	vernichten
მაეგობა	machen, tun, verwenden; machen, tun, verwenden
ნადობა	gegen Entlohnung arbeiten
სიტყუადიდობა	sich großtun, prahlen
შანდობა	lassen, zulassen, gestatten
აღმსდობა	früh aufstehen; früh aufstehen
მესათხევლეობა	fischen
მემსხუერპლეობა	opfern
მღდელთმემსხუერპლეობა	Gottesdienst abhalten
მღდელმემსხუერპლეობა	Gottesdienst abhalten
ძჳრისმოჴსენეობა	nachtragen
მრორინეობა	hin- und herlaufen
მოურნეობა	sorgen, umsorgen, hegen, betreuen
საუკუნეობა	ewig leben / sein
მძჳნვარეობა	wütend sein, toben; wütend sein, toben
წინამსხდომარეობა	vorn sitzen
მცენარეობა	emporwachsen
მძინარეობა	schlafen
ძლევისმოყუარეობა	siegesgewohnt sein, stolz sein
სიბრძნისმოყუარეობა	philosophieren
მეჩქურეობა	faseln, dummes Zeug reden
თანმესამხრეობა	gemeinsam frühstücken
მოსწრაფეობა	streben, eilen
ორდღეობა	zwei Tage bleiben
მეანდერძეობა	testamentarisch vererben
იგავობა	ein Gleichnis sagen
მოკარვობა	leben, wohnen, siedeln, sich niederlassen
ჭირვობა	in Not sein, brauchen, belästigen, bedrängen, fürsorgen; in Not sein, brauchen, belästigen, bedrängen, fürsorgen
კჳრვობა	sich wundern; sich wundern
შელტვობა	naß machen
კათალიკოზობა	Katholikos sein
შთაშთობა	ertränken, ertrinken
თანაგურიობა	zusammen sein
მახიობა	sich verstellen
ანკანაკობა	gemeinsam zechen; gemeinsam zechen
ზადიკობა	feiern; feiern
ხარკობა	bezahlen, dienen, sich mühen, arbeiten, frönen, fürsorgen
შემავალობა	hineingehen
მიმავალობა	hingehen, hinlaufen
მართლმავალობა	richtig gehen, nicht fehlgehen
მკჳრცხლმავალობა	zu Fuß gehen
მიმოვალობა	hin- und hergehen
სიტყჳსმგებლობა	antworten, streiten; antworten, streiten
უდიდებლობა	mißachten
სჯულისმდებლობა	Gesetzgeben, Gesetzeinführen
შჯულისმდებლობა	Gesetzgeben, Gesetzeinführen; Gesetzgeben, Gesetzeinführen
საზღვრისმდებლობა	Grenze festlegen, anordnen
მცვალებლობა	ändern, wechseln; ändern, wechseln
მწამებლობა	bezeugen, bestätigen; bezeugen, bestätigen
ცილისმწამებლობა	verleumden
მაყენებლობა	stören, behindern
დამაყენებლობა	stören, behindern
მსერებლობა	essen
მცხორებლობა	leben
განმაწესებლობა	festlegen, festsetzen
წინაგანმგებელობა	fürsorgen, ordnen, festlegen
მცვალებელობა	ändern, wechseln
განმასრულებელობა	beenden, vollenden
მწამებელობა	bezeugen, bestätigen
ცილისმწამებელობა	verleumden
მყვანებელობა	hinbringen, wegbringen
მაყენებელობა	stören, behindern
მქონებელობა	haben, besitzen
მარწმუნებელობა	überzeugen
კიდეშესაკრებელობა	gesondert eine Versammlung einberufen
ნაყოფისმომღებელობა	Frucht bringen
მიმნიჭებელობა	schenken
მზავობელობა	zustimmen
მვაჭრობელობა	handeln, Handel treiben
მბჭობელობა	Recht sprechen, verurteilen
მჭობელობა	richten, aburteilen
მზიდველობა	ziehen, zerren, hinbringen
მცოდველობა	sündigen
დამტეველობა	zurücklassen
თანამქცეველობა	zusammen sein
მროკველობა	tanzen
მკლველობა	töten, morden
ყრმათმკლველობა	Kinder ermorden
მლტოლველობა	fliehen
ცხოველობა	leben; leben
ჟამისმწირველობა	Messe abhalten
მძრველობა	anstacheln, aufhetzen, Klage einreichen
კარისმცველობა	Tür bewachen
მაღალმზრახველობა	dreist / frech / hochmütig sein
მკრეხველობა	rauben, plündern
მკითხველობა	fragen, ausfragen
მტანჯველობა	peinigen, quälen
მწურთელობა	lehren, unterrichten
მიმცემელობა	übergeben, ausliefern, schenken
ნათლისმცემელობა	taufen
დაუდგრომელობა	unstet sein
ძღუნისმრთუმელობა	eine Gabe überreichen
გულისმთქუმელობა	wünschen
მბანელობა	waschen, baden
მსმენელობა	hören, gehorchen, bereuen
მომსმენელობა	hören
სურნელობა	duften
განმასაზღვრელობა	festlegen
უდებმყოფელობა	mißachten, faulenzen
ანდერძისმყოფელობა	durch Vermächtnis übergeben
ტკბილობა	süß / angenehm sein
ზედაჩრდილობა	bedecken, überschatten
ენაბრგუნვილობა	stottern
შჯულკეთილობა	den Glauben / das Gesetz beachten
გულარძნილობა	beugen, neigen, verraten, meiden; beugen, neigen, verraten, meiden
თანამბრძოლობა	im Kampf beistehen; im Kampf beistehen
მჴეცთმბრძოლობა	gegen wilde Tiere kämpfen
უღლისმბრძოლობა	arbeiten, sich mühen
თანადღესასწაულობა	gemeinsam feiern
თანამედღესასწაულობა	gemeinsam feiern
განპებულობა	spalten
მრჩობლგანპებულობა	in zwei Teile spalten
გარემომრგულობა	rings umgeben
მოქადულობა	prahlen, drohen
ნუკვეულობა	im Luxus leben
ურვეულობა	in Bedrängnis / Not sein, umsorgen
ძმაცვულობა	heimtückisch sein
ზედმიწევნულობა	wissen, erkennen, verstehen
თანამოხარულობა	sich gemeinsam freuen
ძულობა	hassen; hassen
ღიმობა	lächeln
აღბრკმობა	öffnen
ზემტკმობა	Mund öffnen
აღმტკმობა	Mund öffnen
წინააღმდგომობა	Widerstand leisten, sich widersetzen
განდგომობა	abfallen, verraten
ზედმიმწდომობა	erkennen, erfahren, verstehen
მიმომცთომობა	umherlungern
ქრისტეანობა	Christ sein
შთადნობა	hinabschmelzen
უკუნყრდნობა	zurücklehnen
მიყდნობა	sich stützen, sich anlehnen; sich stützen, sich anlehnen
მცენობა	sein
ანპარტავნობა	hochmütig / stolz sein; hochmütig / stolz sein
ჴელოვნობა	arbeiten, machen, verrichten
ჰაეროვნობა	sich amüsieren, wohlleben
ნაყროვნობა	viel essen
ანჯმნობა	sich versammeln, eine Versammlung abhalten
განჴმნობა	ermuntern, ermutigen
დიაკონობა	als Diakon wirken
დამცნობა	beauftragen, befehlen, festlegen; beauftragen, befehlen, festlegen
გძნობა	wissen, erfahren, verstehen, erkennen; wissen, erfahren, verstehen, erkennen
საჩინოობა	sehen lassen, sichtbar sein, deutlich sein; sehen lassen, sichtbar sein, deutlich sein
დაპატიჟობა	einladen
საჴმარობა	verwenden, brauchen
ყუარობა	lieben; lieben
მოფიცარობა	Meineid ablegen / schwören
წადიერობა	wünschen ersehnen
გზისპოვნიერობა	gehen
ღონიერობა	versuchen, bewerkstelligen
მტიერობა	keine Haare haben, kahl sein
ზღვრობა	angrenzen, grenzen
მღამეურობა	wach bleiben, die Nacht wach verbringen
მედღეურობა	Leben verbringen
მღამიურობა	wach bleiben, die Nacht wach verbringen; wach bleiben, die Nacht wach verbringen
დაშურობა	arbeiten lassen, sich mühen lassen, ermüden
მოშურობა	belästigen
დაბყრობა	fangen, fassen, packen, festhalten, mieten; fangen, fassen, packen, festhalten, mieten
წინადაპყრობა	besetzen, erobern
თანაშეპყრობა	gemeinsam zugrundegehen
უკმოპყრობა	zurückgewinnen, wieder an sich reißen
ზედააღპყრობა	hochheben
ზეაღპყრობა	emporziehen, hochziehen
ჴელთაღპყრობა	helfen, unterstützen
სწრობა	einholen, überholen, überraschen, zuvorkommen
წინასწრობა	überholen, zuvorkommen
მისწრობა	rechtzeitig hinkommen; rechtzeitig hinkommen
წარსწრობა	überholen, zuvorkommen; überholen, zuvorkommen
შთათხრობა	eingeben
შეთხრობა	ausrichten lassen
განცხრობა	unterhalten, erfreuen
შემოჭჳრობა	hereinlugen, hereinblicken
უნასობა	unverschämt sein,schaden; unverschämt sein,schaden
უმრწემესობა	gehorsam sein
დავლტობა	naß machen / werden
დასხრტობა	zerstören, zerrütten, auflösen
ტაბაცობა	spielen
მტკიცობა	fest sein, stark sein
ცრუფიცობა	Meineid schwören
ჰამბვა	mitteilen, benachrichtigen
აღმომწუმბვა	beschmutzen, besudeln
ზედახედვა	umsorgen, fürsorgen
მიმოდახედვა	umherblicken
ზედამიხედვა	nachsehen, beaufsichtigen
ზედმიხედვა	beaufsichtigen
წინაჲსწარხედვა	voraussehen
მიმოდაზიდვა	hin- und herneigen
მიკიდვა	sich aufladen, beladen
მშჳლდვა	mit Pfeil und Bogen schießen
განიგურდევა	auf seine Seite ziehen
შემოწყუდევა	einzwängen, umschließen
მოკლევა	töten lassen
მოკუმევა	beweihräuchern
შესუმევა	trinken lassen, tränken
წარმოთქუმევა	sprechen lassen
ქმნევა	machen lassen
შექმნევა	machen lassen
ჴნევა	pflügen lassen
შთამოთრევა	heabzerren, herabschleifen
ზეაღფქურევა	aufwirbeln, emporstäuben lassen
შეცურევა	abkühlen
მოცურევა	pflücken, sammeln
გარდმოცურევა	verstreuen, herabstreuen, versprühen
ჩამონქრევა	vernichten, einreißen, niederreißen
თანააღრევა	vermischen, sich vermischen
ამრღუევა	eintrüben, trüben, vermengen, durcheinanderbringen; eintrüben, trüben, vermengen, durcheinanderbringen
გარემოხუევა	umbinden, umarmen
წინაგანრჩევა	ermitteln, untersuchen
წარმორჩევა	auswählen
ჩქურებად-ქცევა	dumm werden, verblöden
კუალადქცევა	umwenden, zurückwenden
უკუნქცევა	zurückkehren, zurückschicken, zurückgeben, zurückweichen
ზეუკუნქცევა	nach oben zurückkehren
წინაწარქცევა	vor sich hertreiben
გამოძევა	untersuchen, herausfinden, ermitteln
ხრწევა	stören
წილის-თხევა	losen
წართხევა	verschütten, verschüttet werden
თანათხზვა	umarmen
თანაშეთხზვა	sich vereinen
განშანთვა	brandmarken
ზედადართვა	hinzufügen
თანადართვა	hinzufügen, bestätigen, zustimmen
ზედდართვა	hinzufügen
თანაშერთვა	vereinen
თანაგამორთვა	hinzukommen, weggehen
ზედამორთვა	hinzufügen
პურისრთვა	einladen
დაწურთვა	lernen
მოჴუთვა	verpfänden
ჩათუალვა	zählen
წამოთუალვა	aufzählen, zählen
დამჭუალვა	annageln; annageln
დამრჭუალვა	annageln; annageln
შემრჭუალვა	hineinschlagen, hineinbohren; hineinschlagen, hineinbohren
დამშჭუალვა	annageln; annageln
შემშჭუალვა	hineinschlagen, hineinbohren; hineinschlagen, hineinbohren
განმშჭუალვა	hineinspießen, hineinbohren; hineinspießen, hineinbohren
მოშალვა	zerstören, zerrütten
დაკძალვა	meiden; aufbewahren, schützen, schließen, gefangennehmen; bestatten; meiden; aufbewahren, schützen, schließen, gefangennehmen; bestatten
თანატყუელვა	mit Beifallklatschen begleiten
წინაშეხუმილვა	verteidigen, schützen, bewachen
მჴუმილვა	wachen, bewachen, beschützen
წურილვა	untersuchen, ermitteln, befragen; untersuchen, ermitteln, befragen
გამოწურილვა	genau untersuchen, in allen Einzelheiten ermitteln; genau untersuchen, in allen Einzelheiten ermitteln
განწილვა	teilen
ზედამიხილვა	beaufsichtigen, umsorgen
უკუნხილვა	zurückblicken
გარეუკუნხილვა	zurückblicken
ზედმოხილვა	erblicken, ansehen, ausspionieren
გარემოხილვა	betrachten, umhersehen
გემოჲსხილვა	kosten, essen
კაცის-კლვა	(einen Menschen) töten
მამლვა	sich paaren (von Tieren)
ყურიმლვა	eine Ohrfeige geben
გბოლვა	kochen
მოოლვა	schmücken, herrichten
ვლტოლვა	fliehen, wegrennen
განვლტოლვა	entfliehen
გამოტკფოლვა	bersten, zerplatzen, zerspringen
შეგლძოლვა	weich werden, aufweichen
მსხუერპლვა	opfern
თანასლვა	begleiten
წასლვა	weggehen, sich entfernen, vergehen
ზედამოსლვა	kommen, angreifen
უკმოსლვა	zurückkehren, umkehren
წაღმოსლვა	herkommen, hergehen; herkommen, hergehen
წინაწარსლვა	vorausgehen
ქმრისსლვა	heiraten
მოღულვა	zerstampfen, zerfetzen
შერჩულვა	lehren, unterrichten, unterweisen
შთაფლვა	bedecken, vergraben
ნავღლვა	streiten
უკუჭურჭლვა	hinübertragen
დასხლვა	ausästen, verschneiden, abschneiden
მოსხლვა	beschneiden (äste)
მოკუფხლვა	pflücken
განკაზმვა	sich vorbereiten, bereiten
მოლერწმვა	töten, umbringen
დათხზნვა	flechten; flechten
თნვა	gefallen
დაჴუერთნვა	mit der Faust schlagen
განკუთნვა	übereignen; festlegen; übereignen; festlegen
შეკუმინვა	sich sorgen
ჭრჭინვა	zwitschern
მისნვა	wahrsagen, vorhersehen, zaubern
მოერქუნვა	pflügen
ანიშნვა	bezeichnen, bestimmen
დანიშნვა	bemerken, verstehen, begreifen, bekanntgeben
ქუცნვა	zerkrümeln, zermalmen
დაკირძნვა	wünschen, begehren, erstreben
მოყურძნვა	pflücken, sich besorgen, sich verschaffen
კრკჳნვა	fürsorgen, betreuen
ტრტჳნვა	sich empören, unzufrieden sein; sich empören, unzufrieden sein
მოსტჳნვა	pfeifend kommen
მოყჳნვა	schneiden, abschneiden
შფოთოვა	erregt / empört sein, einen Aufstand machen
ჭავლოვა	hervorsprudeln, sprudeln
ცილმწერლოვა	Unwahrheit schreiben
თესლოვა	Samen ausbilden
პერულოვა	aufschäumen
ქედმაღლოვა	hochmütig sein
გამოჯეჯლოვა	sprießen
კუმოვა	rauchen
წყაროვა	herausfließen
ნაყროვა	übermäßig essen
მწიფოვა	reifen
მტკიცოვა	bekräftigen, beweisen
განთხოვა	heiraten (von der Frau), verheiraten (eine Frau)
ზუხოვა	stöhnen, seufzen
დასხირპვა	sich ausstrecken
მიმოდაფარვა	zudecken, bedecken
წარბერვა	hineinblasen
წარკერვა	zunähen
შეჭკერვა	zusammenfassen, bündeln
მოზუერვა	sammeln, anhäufen
ჰაზრვა	begreifen, verstehen
თრვა	sich betrinken, betrunken sein
შეზუმირვა	mit Myrrhe einreiben; mit Myrrhe einreiben
პირისა დაკრვა	zum Schweigen bringen
თანაშეკრვა	verbinden, verknüpfen
მოკრვა	umbinden, umwickeln
აღკრვა	andrücken, anpressen
მიმოდაგორვა	umherrollen, umherwälzen
მიმოგორვა	hin- und herrollen, hin- und herwälzen
ზედაგარდაბურვა	überdecken
წარმობურვა	überdecken
მოცრვა	umherstreuen
განვაჭრვა	verkauft werden
შეზმჳრვა	mit Myrrhe einreiben
მიმოგანთესვა	verstreuen
შთამოთესვა	hereinsäen, hereinbringen
შემოთესვა	hineinsäen
შთამოლესვა	herabschaben, herabreißen
ქმრისვა	heiraten
შექუსვა	miteinander verbinden / verweben, verschmelzen; Zeit vertreiben
თანაშექუსვა	vereinen, verbinden
ჴსვა	schließen; schließen
დაჴსვა	schließen; schließen
ტუვა	lügen
განძუარცუვა	wegnehmen, rauben, ausziehen; wegnehmen, rauben, ausziehen
შეღუერფვა	anhäufen, hinwerfen
უკუმოზღვა	vergüten, entgelten, zurückgeben
დაჴრშვა	schließen; schließen
თანალოცვა	gemeinsam beten
წარნახვა	überprüfen
მოზრახვა	schwätzen, quatschen
წარმოზრახვა	sprechen, aussprechen
შთატეხვა	einschlagen, einbrechen
თანამარხვა	gemeinsam fasten
შემჭუხვა	verzerren (Gesicht vor Trauer)
არაცხვა	zählen; zählen
გუალე	geh!
გარდაგუალე	geh hinüber!
შთაგუალე	steig hinab!
შეგუალე	geh hinein!
განგუალე	geh hinaus!
მოგუალე	komm!
გამოგუალე	komm heraus!
წარმოგუალე	komm mit!
აღმოგუალე	komm herauf!
წარგუალე	geh fort!
აღგუალე	schreite hinauf!
